StoreNumber,BatchNumber,SKU,ONHAND,ScannedCnt,Diff,BatchPass,BatchPassDecr,DateCreated
111,1,1,4,3,1,3,Variance 1,2022-08-08 16:33:12.540
111,1,3,12,12,0,1,Batch Pass 1,2022-08-08 16:11:16.920
111,1,47,49,47,2,1,Batch Pass 1,2022-08-08 16:11:16.920
111,1,2,11,8,3,3,Variance 1,2022-08-08 16:33:12.540
111,1,1,7,7,0,3,Variance 1,2022-08-08 16:33:12.540
111,1,10,20,20,0,1,Batch Pass 1,2022-08-08 16:11:16.920
111,1,1,3,2,1,3,Variance 1,2022-08-08 16:33:12.540
111,1,16,48,48,0,1,Batch Pass 1,2022-08-08 16:11:16.920
111,1,1,7,6,1,1,Batch Pass 1,2022-08-08 16:11:16.920
111,1,1,12,9,3,3,Variance 1,2022-08-08 16:33:12.540
134,5,11,55,55,0,1,Batch Pass 1,2022-08-12 10:49:56.250
134,5,1,9,8,1,1,Batch Pass 1,2022-08-12 10:49:56.250
134,5,47,53,47,6,1,Batch Pass 1,2022-08-12 10:49:56.250
134,5,13,55,52,3,1,Batch Pass 1,2022-08-12 10:49:56.250
134,5,1,8,7,1,1,Batch Pass 1,2022-08-12 10:49:56.250
134,5,36,110,108,2,1,Batch Pass 1,2022-08-12 10:49:56.250
134,5,2,12,12,0,1,Batch Pass 1,2022-08-12 10:49:56.250
134,5,49,105,98,7,1,Batch Pass 1,2022-08-12 10:49:56.250
134,4,38,80,76,4,1,Batch Pass 1,2022-08-11 17:39:11.800
134,4,2,16,12,4,6,Variance 4,2022-08-11 18:08:04.930
134,4,16,16,0,16,1,Batch Pass 1,2022-08-11 17:39:11.800
134,4,6,17,0,17,6,Variance 4,2022-08-11 18:08:04.930
134,4,17,54,51,3,1,Batch Pass 1,2022-08-11 17:39:11.800
134,4,4,18,12,6,6,Variance 4,2022-08-11 18:08:04.930
134,4,2,12,12,0,1,Batch Pass 1,2022-08-11 17:39:11.800
134,4,136,140,136,4,1,Batch Pass 1,2022-08-11 17:39:11.800
134,4,6,17,6,11,6,Variance 4,2022-08-11 18:08:04.930
134,4,7,28,28,0,1,Batch Pass 1,2022-08-11 17:39:11.800
134,4,2,12,8,4,6,Variance 4,2022-08-11 18:08:04.930
134,4,2,7,2,5,8,Variance 4 Supplement,2022-08-12 10:49:56.250
134,4,1,2,2,0,6,Variance 4,2022-08-11 18:08:04.930
134,4,7,35,35,0,1,Batch Pass 1,2022-08-11 17:39:11.800
134,4,1,7,8,-1,1,Batch Pass 1,2022-08-11 17:39:11.800
134,4,1,8,8,0,6,Variance 4,2022-08-11 18:08:04.930
134,3,5,18,0,18,5,Varaince 3,2022-08-10 13:08:03.160
134,3,132,138,132,6,1,Batch Pass 1,2022-08-10 12:35:39.177
134,3,2,15,14,1,5,Varaince 3,2022-08-10 13:08:03.160
134,3,1,13,14,-1,1,Batch Pass 1,2022-08-10 12:35:39.177
134,3,2,6,2,4,5,Varaince 3,2022-08-10 13:08:03.160
134,3,38,78,76,2,1,Batch Pass 1,2022-08-10 12:35:39.177
134,3,4,20,20,0,1,Batch Pass 1,2022-08-10 12:35:39.177
134,3,1,12,12,0,1,Batch Pass 1,2022-08-10 12:35:39.177
134,3,1,16,15,1,1,Batch Pass 1,2022-08-10 12:35:39.177
134,3,12,12,0,12,1,Batch Pass 1,2022-08-10 12:35:39.177
134,3,2,9,4,5,5,Varaince 3,2022-08-10 13:08:03.160
134,3,17,54,51,3,1,Batch Pass 1,2022-08-10 12:35:39.177
134,3,3,18,18,0,1,Batch Pass 1,2022-08-10 12:35:39.177
134,3,1,10,8,2,5,Varaince 3,2022-08-10 13:08:03.160
134,3,2,8,6,2,5,Varaince 3,2022-08-10 13:08:03.160
134,3,7,28,28,0,1,Batch Pass 1,2022-08-10 12:35:39.177
134,3,2,14,14,0,1,Batch Pass 1,2022-08-10 12:35:39.177
134,2,115,118,115,3,1,Batch Pass 1,2022-08-09 15:22:30.960
134,2,1,9,8,1,1,Batch Pass 1,2022-08-09 15:22:30.960
134,2,2,6,6,0,4,Variance 2,2022-08-09 15:43:53.913
134,2,4,16,16,0,1,Batch Pass 1,2022-08-09 15:22:30.960
134,2,1,6,6,0,4,Variance 2,2022-08-09 15:43:53.913
134,2,1,8,7,1,1,Batch Pass 1,2022-08-09 15:22:30.960
134,2,1,13,13,0,1,Batch Pass 1,2022-08-09 15:22:30.960
134,2,22,22,0,22,1,Batch Pass 1,2022-08-09 15:22:30.960
134,2,11,47,0,47,4,Variance 2,2022-08-09 15:43:53.913
134,2,12,37,36,1,1,Batch Pass 1,2022-08-09 15:22:30.960
134,2,2,19,18,1,1,Batch Pass 1,2022-08-09 15:22:30.960
134,2,1,3,1,2,4,Variance 2,2022-08-09 15:43:53.913
134,2,38,76,76,0,1,Batch Pass 1,2022-08-09 15:22:30.960
134,2,5,25,25,0,1,Batch Pass 1,2022-08-09 15:22:30.960
134,2,1,11,11,0,4,Variance 2,2022-08-09 15:43:53.913
134,1,14,32,0,32,3,Variance 1,2022-08-08 18:08:30.113
134,1,2,13,12,1,1,Batch Pass 1,2022-08-08 16:52:51.967
134,1,1,12,13,-1,3,Variance 1,2022-08-08 18:08:30.113
134,1,30,61,60,1,1,Batch Pass 1,2022-08-08 16:52:51.967
134,1,1,3,3,0,3,Variance 1,2022-08-08 18:08:30.113
134,1,3,16,15,1,1,Batch Pass 1,2022-08-08 16:52:51.967
134,1,3,18,18,0,3,Variance 1,2022-08-08 18:08:30.113
134,1,1,8,8,0,1,Batch Pass 1,2022-08-08 16:52:51.967
134,1,1,11,11,0,1,Batch Pass 1,2022-08-08 16:52:51.967
134,1,139,145,139,6,1,Batch Pass 1,2022-08-08 16:52:51.967
134,1,1,5,2,3,3,Variance 1,2022-08-08 18:08:30.113
134,1,5,21,20,1,1,Batch Pass 1,2022-08-08 16:52:51.967
134,1,3,20,21,-1,1,Batch Pass 1,2022-08-08 16:52:51.967
134,1,1,14,14,0,1,Batch Pass 1,2022-08-08 16:52:51.967
134,1,14,14,0,14,1,Batch Pass 1,2022-08-08 16:52:51.967
134,1,4,10,4,6,3,Variance 1,2022-08-08 18:08:30.113
134,1,13,40,39,1,1,Batch Pass 1,2022-08-08 16:52:51.967
134,1,4,17,16,1,3,Variance 1,2022-08-08 18:08:30.113
171,5,130,131,130,1,1,Batch Pass 1,2022-08-12 07:55:20.883
171,5,17,69,68,1,1,Batch Pass 1,2022-08-12 07:55:20.883
171,5,1,7,7,0,1,Batch Pass 1,2022-08-12 07:55:20.883
171,5,3,11,21,-10,7,Variance 5,2022-08-12 08:26:57.800
171,5,66,135,132,3,1,Batch Pass 1,2022-08-12 07:55:20.883
171,5,3,10,9,1,7,Variance 5,2022-08-12 08:26:57.800
171,5,5,25,25,0,1,Batch Pass 1,2022-08-12 07:55:20.883
171,5,1,8,8,0,1,Batch Pass 1,2022-08-12 07:55:20.883
171,5,3,7,6,1,7,Variance 5,2022-08-12 08:26:57.800
171,5,1,2,5,-3,7,Variance 5,2022-08-12 08:26:57.800
171,5,3,7,3,4,7,Variance 5,2022-08-12 08:26:57.800
171,5,32,97,96,1,1,Batch Pass 1,2022-08-12 07:55:20.883
171,4,1,3,1,2,6,Variance 4,2022-08-11 14:25:25.553
171,4,1,2,4,-2,6,Variance 4,2022-08-11 14:25:25.553
171,4,38,98,0,98,8,Variance 4 Supplement,2022-08-11 18:10:47.977
171,4,1,1,1,0,1,Batch Pass 1,2022-08-11 14:25:25.553
171,4,3,7,6,1,6,Variance 4,2022-08-11 14:25:25.553
171,4,1,1,1,0,1,Batch Pass 1,2022-08-11 14:11:27.157
171,4,3,9,9,0,6,Variance 4,2022-08-11 14:25:25.553
171,3,39,77,78,-1,1,Batch Pass 1,2022-08-10 13:03:19.257
171,3,2,11,10,1,1,Batch Pass 1,2022-08-10 13:03:19.257
171,3,167,176,167,9,1,Batch Pass 1,2022-08-10 13:03:19.257
171,3,2,7,6,1,5,Varaince 3,2022-08-10 13:52:22.040
171,3,1,5,6,-1,5,Varaince 3,2022-08-10 13:52:22.040
171,3,1,9,8,1,1,Batch Pass 1,2022-08-10 13:03:19.257
171,3,5,21,20,1,1,Batch Pass 1,2022-08-10 13:03:19.257
171,3,1,8,7,1,5,Varaince 3,2022-08-10 13:52:22.040
171,3,1,24,33,-9,5,Varaince 3,2022-08-10 13:52:22.040
171,3,4,15,4,11,5,Varaince 3,2022-08-10 13:52:22.040
171,3,17,51,51,0,1,Batch Pass 1,2022-08-10 13:03:19.257
171,3,2,13,12,1,1,Batch Pass 1,2022-08-10 13:03:19.257
171,3,1,10,9,1,1,Batch Pass 1,2022-08-10 13:03:19.257
171,2,143,151,143,8,1,Batch Pass 1,2022-08-09 13:22:22.037
171,2,3,6,9,-3,4,Variance 2,2022-08-10 07:04:25.763
171,2,1,8,8,0,1,Batch Pass 1,2022-08-09 13:22:22.037
171,2,1,11,11,0,1,Batch Pass 1,2022-08-09 13:22:22.037
171,2,38,76,76,0,1,Batch Pass 1,2022-08-09 13:22:22.037
171,2,4,21,20,1,1,Batch Pass 1,2022-08-09 13:22:22.037
171,2,1,12,12,0,1,Batch Pass 1,2022-08-09 13:22:22.037
171,2,4,12,4,8,4,Variance 2,2022-08-10 07:04:25.763
171,2,12,37,36,1,1,Batch Pass 1,2022-08-09 13:22:22.037
171,2,3,8,12,-4,4,Variance 2,2022-08-10 07:04:25.763
171,2,1,16,16,0,1,Batch Pass 1,2022-08-09 13:22:22.037
171,2,1,7,2,5,4,Variance 2,2022-08-10 07:04:25.763
171,2,7,28,28,0,1,Batch Pass 1,2022-08-09 13:22:22.037
171,2,2,14,14,0,1,Batch Pass 1,2022-08-09 13:22:22.037
171,2,1,4,8,-4,4,Variance 2,2022-08-10 07:04:25.763
171,1,3,11,6,5,3,Variance 1,2022-08-08 16:55:41.950
171,1,1,8,8,0,3,Variance 1,2022-08-08 16:55:41.950
171,1,171,180,171,9,1,Batch Pass 1,2022-08-08 16:32:29.940
171,1,4,16,16,0,1,Batch Pass 1,2022-08-08 16:32:29.940
171,1,1,6,6,0,3,Variance 1,2022-08-08 16:55:41.950
171,1,39,82,78,4,1,Batch Pass 1,2022-08-08 16:32:29.940
171,1,1,3,3,0,3,Variance 1,2022-08-08 16:55:41.950
171,1,3,15,15,0,1,Batch Pass 1,2022-08-08 16:32:29.940
171,1,2,6,2,4,3,Variance 1,2022-08-08 16:55:41.950
171,1,16,47,48,-1,1,Batch Pass 1,2022-08-08 16:32:29.940
171,1,4,25,24,1,1,Batch Pass 1,2022-08-08 16:32:29.940
171,1,1,9,9,0,1,Batch Pass 1,2022-08-08 16:32:29.940
174,4,1,4,2,2,6,Variance 4,2022-08-11 16:00:28.150
174,4,8,32,32,0,1,Batch Pass 1,2022-08-11 13:54:19.263
174,4,3,14,15,-1,6,Variance 4,2022-08-11 16:00:28.150
174,4,2,14,14,0,1,Batch Pass 1,2022-08-11 13:54:19.263
174,4,1,17,17,0,1,Batch Pass 1,2022-08-11 13:54:19.263
174,4,1,26,24,2,6,Variance 4,2022-08-11 16:00:28.150
174,4,80,90,80,10,1,Batch Pass 1,2022-08-11 13:54:19.263
174,4,4,20,20,0,1,Batch Pass 1,2022-08-11 13:54:19.263
174,4,2,15,16,-1,1,Batch Pass 1,2022-08-11 13:54:19.263
174,4,3,37,0,37,6,Variance 4,2022-08-11 16:00:28.150
174,4,22,43,44,-1,1,Batch Pass 1,2022-08-11 13:54:19.263
174,4,3,7,9,-2,6,Variance 4,2022-08-11 16:00:28.150
174,4,1,9,9,0,1,Batch Pass 1,2022-08-11 13:54:19.263
174,4,1,18,18,0,1,Batch Pass 1,2022-08-11 13:54:19.263
174,4,1,17,19,-2,6,Variance 4,2022-08-11 16:00:28.150
174,4,8,8,0,8,1,Batch Pass 1,2022-08-11 13:54:19.263
174,4,3,11,3,8,6,Variance 4,2022-08-11 16:00:28.150
174,4,17,52,51,1,1,Batch Pass 1,2022-08-11 13:54:19.263
174,4,5,31,30,1,1,Batch Pass 1,2022-08-11 13:54:19.263
174,3,11,11,0,11,1,Batch Pass 1,2022-08-10 11:21:06.423
174,3,5,14,0,14,5,Varaince 3,2022-08-10 13:16:32.077
174,3,10,32,30,2,1,Batch Pass 1,2022-08-10 11:21:06.423
174,3,1,11,10,1,1,Batch Pass 1,2022-08-10 11:21:06.423
174,3,1,7,10,-3,5,Varaince 3,2022-08-10 13:16:32.077
174,3,1,14,13,1,5,Varaince 3,2022-08-10 13:16:32.077
174,3,1,3,1,2,5,Varaince 3,2022-08-10 13:16:32.077
174,3,2,9,8,1,5,Varaince 3,2022-08-10 13:16:32.077
174,3,1,9,9,0,1,Batch Pass 1,2022-08-10 11:21:06.423
174,3,18,40,36,4,1,Batch Pass 1,2022-08-10 11:21:06.423
174,3,2,12,4,8,5,Varaince 3,2022-08-10 13:16:32.077
174,3,4,20,20,0,1,Batch Pass 1,2022-08-10 11:21:06.423
174,3,1,9,5,4,5,Varaince 3,2022-08-10 13:16:32.077
174,3,1,8,8,0,1,Batch Pass 1,2022-08-10 11:21:06.423
174,3,1,18,18,0,1,Batch Pass 1,2022-08-10 11:21:06.423
174,3,61,66,61,5,1,Batch Pass 1,2022-08-10 11:21:06.423
174,3,9,39,36,3,1,Batch Pass 1,2022-08-10 11:21:06.423
174,3,1,7,7,0,1,Batch Pass 1,2022-08-10 11:21:06.423
174,3,1,9,9,0,5,Varaince 3,2022-08-10 13:16:32.077
174,3,1,33,33,0,1,Batch Pass 1,2022-08-10 11:21:06.423
174,2,122,128,122,6,1,Batch Pass 1,2022-08-09 13:00:32.717
174,2,1,3,1,2,4,Variance 2,2022-08-09 14:48:21.190
174,2,9,37,36,1,1,Batch Pass 1,2022-08-09 13:00:32.717
174,2,3,11,12,-1,4,Variance 2,2022-08-09 14:48:21.190
174,2,1,11,11,0,1,Batch Pass 1,2022-08-09 13:00:32.717
174,2,1,28,27,1,1,Batch Pass 1,2022-08-09 13:00:32.717
174,2,2,2,0,2,1,Batch Pass 1,2022-08-09 13:00:32.717
174,2,2,5,6,-1,4,Variance 2,2022-08-09 14:48:21.190
174,2,1,3,6,-3,4,Variance 2,2022-08-09 14:48:21.190
174,2,2,15,14,1,1,Batch Pass 1,2022-08-09 13:00:32.717
174,2,1,1,2,-1,4,Variance 2,2022-08-09 14:48:21.190
174,2,15,47,45,2,1,Batch Pass 1,2022-08-09 13:00:32.717
174,2,4,23,24,-1,1,Batch Pass 1,2022-08-09 13:00:32.717
174,2,1,8,9,-1,1,Batch Pass 1,2022-08-09 13:00:32.717
174,2,2,12,18,-6,4,Variance 2,2022-08-09 14:48:21.190
174,2,26,52,52,0,1,Batch Pass 1,2022-08-09 13:00:32.717
174,2,8,40,40,0,1,Batch Pass 1,2022-08-09 13:00:32.717
174,2,1,6,5,1,4,Variance 2,2022-08-09 14:48:21.190
174,1,3,7,3,4,3,Variance 1,2022-08-08 18:40:15.500
174,1,2,11,8,3,3,Variance 1,2022-08-08 18:40:15.500
174,1,3,15,15,0,1,Batch Pass 1,2022-08-08 17:13:04.597
174,1,100,106,100,6,1,Batch Pass 1,2022-08-08 17:13:04.597
174,1,6,24,24,0,1,Batch Pass 1,2022-08-08 17:13:04.597
174,1,1,4,5,-1,3,Variance 1,2022-08-08 18:40:15.500
174,1,2,14,14,0,1,Batch Pass 1,2022-08-08 17:13:04.597
174,1,1,9,10,-1,1,Batch Pass 1,2022-08-08 17:13:04.597
174,1,8,8,0,8,1,Batch Pass 1,2022-08-08 17:13:04.597
174,1,2,9,4,5,3,Variance 1,2022-08-08 18:40:15.500
174,1,15,44,45,-1,1,Batch Pass 1,2022-08-08 17:13:04.597
174,1,1,6,6,0,1,Batch Pass 1,2022-08-08 17:13:04.597
174,1,1,2,0,2,3,Variance 1,2022-08-08 18:40:15.500
174,1,35,73,70,3,1,Batch Pass 1,2022-08-08 17:13:04.597
174,1,3,7,9,-2,3,Variance 1,2022-08-08 18:40:15.500
231,4,127,133,127,6,1,Batch Pass 1,2022-08-11 15:15:34.727
231,4,3,10,6,4,6,Variance 4,2022-08-11 15:50:13.763
231,4,8,31,32,-1,1,Batch Pass 1,2022-08-11 15:15:34.727
231,4,1,3,5,-2,6,Variance 4,2022-08-11 15:50:13.763
231,4,1,7,7,0,1,Batch Pass 1,2022-08-11 15:15:34.727
231,4,1,3,8,-5,6,Variance 4,2022-08-11 15:50:13.763
231,4,2,5,2,3,6,Variance 4,2022-08-11 15:50:13.763
231,4,23,73,69,4,1,Batch Pass 1,2022-08-11 15:15:34.727
231,4,1,2,4,-2,6,Variance 4,2022-08-11 15:50:13.763
231,4,1,6,7,-1,6,Variance 4,2022-08-11 15:50:13.763
231,4,1,10,10,0,1,Batch Pass 1,2022-08-11 15:15:34.727
231,4,1,6,3,3,6,Variance 4,2022-08-11 15:50:13.763
231,4,2,13,12,1,1,Batch Pass 1,2022-08-11 15:15:34.727
231,4,34,69,68,1,1,Batch Pass 1,2022-08-11 15:15:34.727
231,4,6,30,30,0,1,Batch Pass 1,2022-08-11 15:15:34.727
231,4,1,8,8,0,1,Batch Pass 1,2022-08-11 15:15:34.727
231,3,113,117,113,4,1,Batch Pass 1,2022-08-10 15:49:55.493
231,3,1,1,3,-2,5,Varaince 3,2022-08-10 16:46:35.563
231,3,4,16,16,0,1,Batch Pass 1,2022-08-10 15:49:55.493
231,3,1,3,6,-3,5,Varaince 3,2022-08-10 16:46:35.563
231,3,29,59,58,1,1,Batch Pass 1,2022-08-10 15:49:55.493
231,3,2,10,8,2,5,Varaince 3,2022-08-10 16:46:35.563
231,3,5,26,25,1,1,Batch Pass 1,2022-08-10 15:49:55.493
231,3,1,7,7,0,5,Varaince 3,2022-08-10 16:46:35.563
231,3,2,16,16,0,1,Batch Pass 1,2022-08-10 15:49:55.493
231,3,1,5,1,4,5,Varaince 3,2022-08-10 16:46:35.563
231,3,8,25,24,1,1,Batch Pass 1,2022-08-10 15:49:55.493
231,3,3,19,18,1,1,Batch Pass 1,2022-08-10 15:49:55.493
231,3,2,9,4,5,5,Varaince 3,2022-08-10 16:46:35.563
231,3,1,8,5,3,5,Varaince 3,2022-08-10 16:46:35.563
231,3,1,7,7,0,1,Batch Pass 1,2022-08-10 15:49:55.493
231,2,23,48,46,2,1,Batch Pass 1,2022-08-09 17:05:38.313
231,2,1,4,4,0,4,Variance 2,2022-08-09 19:04:34.260
231,2,3,15,15,0,1,Batch Pass 1,2022-08-09 17:05:38.313
231,2,81,87,81,6,1,Batch Pass 1,2022-08-09 17:05:38.313
231,2,2,8,6,2,4,Variance 2,2022-08-09 19:04:34.260
231,2,4,15,16,-1,1,Batch Pass 1,2022-08-09 17:05:38.313
231,2,3,21,21,0,1,Batch Pass 1,2022-08-09 17:05:38.313
231,2,1,9,10,-1,1,Batch Pass 1,2022-08-09 17:05:38.313
231,2,14,44,42,2,1,Batch Pass 1,2022-08-09 17:05:38.313
231,2,4,24,24,0,1,Batch Pass 1,2022-08-09 17:05:38.313
231,2,2,18,18,0,1,Batch Pass 1,2022-08-09 17:05:38.313
231,1,32,66,64,2,1,Batch Pass 1,2022-08-08 18:47:41.933
231,1,1,5,3,2,3,Variance 1,2022-08-09 10:32:12.830
231,1,4,19,20,-1,1,Batch Pass 1,2022-08-08 18:47:41.933
231,1,100,103,100,3,1,Batch Pass 1,2022-08-08 18:47:41.933
231,1,1,6,6,0,3,Variance 1,2022-08-09 10:32:12.830
231,1,1,11,15,-4,3,Variance 1,2022-08-09 10:32:12.830
231,1,2,5,4,1,3,Variance 1,2022-08-09 10:32:12.830
231,1,13,53,52,1,1,Batch Pass 1,2022-08-08 18:47:41.933
231,1,2,16,16,0,3,Variance 1,2022-08-09 10:32:12.830
231,1,13,39,39,0,1,Batch Pass 1,2022-08-08 18:47:41.933
231,1,4,24,24,0,1,Batch Pass 1,2022-08-08 18:47:41.933
231,1,1,16,16,0,1,Batch Pass 1,2022-08-08 18:47:41.933
232,4,15,36,0,36,6,Variance 4,2022-08-11 18:57:02.573
232,4,16,49,48,1,1,Batch Pass 1,2022-08-11 17:51:16.923
232,4,2,12,12,0,1,Batch Pass 1,2022-08-11 17:51:16.923
232,4,22,22,0,22,1,Batch Pass 1,2022-08-11 17:51:16.923
232,4,5,9,5,4,6,Variance 4,2022-08-11 18:57:02.573
232,4,2,24,8,16,6,Variance 4,2022-08-11 18:57:02.573
232,4,100,105,100,5,1,Batch Pass 1,2022-08-11 17:51:16.923
232,4,8,31,32,-1,1,Batch Pass 1,2022-08-11 17:51:16.923
232,4,4,21,20,1,6,Variance 4,2022-08-11 18:57:02.573
232,4,1,12,11,1,1,Batch Pass 1,2022-08-11 17:51:16.923
232,4,36,73,72,1,1,Batch Pass 1,2022-08-11 17:51:16.923
232,4,7,19,21,-2,6,Variance 4,2022-08-11 18:57:02.573
232,4,2,10,10,0,1,Batch Pass 1,2022-08-11 17:51:16.923
232,4,2,12,12,0,6,Variance 4,2022-08-11 18:57:02.573
232,4,1,9,9,0,6,Variance 4,2022-08-11 18:57:02.573
232,4,1,34,34,0,1,Batch Pass 1,2022-08-11 17:51:16.923
232,3,30,62,60,2,1,Batch Pass 1,2022-08-10 17:53:03.733
232,3,5,26,25,1,1,Batch Pass 1,2022-08-10 17:53:03.733
232,3,1,9,8,1,5,Varaince 3,2022-08-10 19:19:47.873
232,3,1,11,11,0,5,Varaince 3,2022-08-10 19:19:47.873
232,3,27,27,0,27,1,Batch Pass 1,2022-08-10 17:53:03.733
232,3,4,9,4,5,5,Varaince 3,2022-08-10 19:19:47.873
232,3,10,29,30,-1,1,Batch Pass 1,2022-08-10 17:53:03.733
232,3,6,24,24,0,5,Varaince 3,2022-08-10 19:19:47.873
232,3,2,12,12,0,1,Batch Pass 1,2022-08-10 17:53:03.733
232,3,1,7,7,0,5,Varaince 3,2022-08-10 19:19:47.873
232,3,1,9,9,0,1,Batch Pass 1,2022-08-10 17:53:03.733
232,3,1,20,20,0,5,Varaince 3,2022-08-10 19:19:47.873
232,3,12,35,0,35,5,Varaince 3,2022-08-10 19:19:47.873
232,3,9,29,27,2,5,Varaince 3,2022-08-10 19:19:47.873
232,3,9,38,36,2,1,Batch Pass 1,2022-08-10 17:53:03.733
232,3,1,6,6,0,5,Varaince 3,2022-08-10 19:19:47.873
232,3,90,92,90,2,1,Batch Pass 1,2022-08-10 17:53:03.733
232,3,6,12,12,0,5,Varaince 3,2022-08-10 19:19:47.873
232,3,2,16,16,0,1,Batch Pass 1,2022-08-10 17:53:03.733
232,2,27,54,54,0,1,Batch Pass 1,2022-08-09 16:48:35.380
232,2,7,17,14,3,4,Variance 2,2022-08-09 18:31:10.707
232,2,3,14,15,-1,1,Batch Pass 1,2022-08-09 16:48:35.380
232,2,2,10,10,0,4,Variance 2,2022-08-09 18:31:10.707
232,2,1,8,8,0,1,Batch Pass 1,2022-08-09 16:48:35.380
232,2,1,11,8,3,4,Variance 2,2022-08-09 18:31:10.707
232,2,132,135,132,3,1,Batch Pass 1,2022-08-09 16:48:35.380
232,2,6,19,18,1,4,Variance 2,2022-08-09 18:31:10.707
232,2,14,56,56,0,1,Batch Pass 1,2022-08-09 16:48:35.380
232,2,1,4,6,-2,4,Variance 2,2022-08-09 18:31:10.707
232,2,1,25,25,0,4,Variance 2,2022-08-09 18:31:10.707
232,2,12,12,0,12,1,Batch Pass 1,2022-08-09 16:48:35.380
232,2,11,24,0,24,4,Variance 2,2022-08-09 18:31:10.707
232,2,2,13,14,-1,1,Batch Pass 1,2022-08-09 16:48:35.380
232,2,1,15,16,-1,1,Batch Pass 1,2022-08-09 16:48:35.380
232,2,1,2,1,1,4,Variance 2,2022-08-09 18:31:10.707
232,2,20,59,60,-1,1,Batch Pass 1,2022-08-09 16:48:35.380
232,2,1,6,6,0,1,Batch Pass 1,2022-08-09 16:48:35.380
232,1,32,65,64,1,1,Batch Pass 1,2022-08-08 18:42:34.763
232,1,5,19,10,9,3,Variance 1,2022-08-08 19:31:37.363
232,1,8,41,40,1,1,Batch Pass 1,2022-08-08 18:42:34.763
232,1,1,9,5,4,3,Variance 1,2022-08-08 19:31:37.363
232,1,1,8,8,0,1,Batch Pass 1,2022-08-08 18:42:34.763
232,1,91,97,91,6,1,Batch Pass 1,2022-08-08 18:42:34.763
232,1,3,9,3,6,3,Variance 1,2022-08-08 19:31:37.363
232,1,5,20,20,0,1,Batch Pass 1,2022-08-08 18:42:34.763
232,1,1,4,4,0,3,Variance 1,2022-08-08 19:31:37.363
232,1,1,7,7,0,3,Variance 1,2022-08-08 19:31:37.363
232,1,1,11,11,0,1,Batch Pass 1,2022-08-08 18:42:34.763
232,1,25,25,0,25,1,Batch Pass 1,2022-08-08 18:42:34.763
232,1,18,42,0,42,3,Variance 1,2022-08-08 19:31:37.363
232,1,2,7,6,1,3,Variance 1,2022-08-08 19:31:37.363
232,1,1,8,7,1,1,Batch Pass 1,2022-08-08 18:42:34.763
232,1,1,16,16,0,3,Variance 1,2022-08-08 19:31:37.363
232,1,13,40,39,1,1,Batch Pass 1,2022-08-08 18:42:34.763
232,1,4,23,24,-1,1,Batch Pass 1,2022-08-08 18:42:34.763
232,1,1,10,9,1,1,Batch Pass 1,2022-08-08 18:42:34.763
233,5,57,115,114,1,1,Batch Pass 1,2022-08-10 11:35:53.393
233,5,5,11,15,-4,7,Variance 5,2022-08-10 12:20:31.567
233,5,10,49,50,-1,1,Batch Pass 1,2022-08-10 11:35:53.393
233,5,3,19,18,1,7,Variance 5,2022-08-10 12:20:31.567
233,5,3,23,24,-1,1,Batch Pass 1,2022-08-10 11:35:53.393
233,5,1,9,9,0,7,Variance 5,2022-08-10 12:20:31.567
233,5,1,21,19,2,7,Variance 5,2022-08-10 12:20:31.567
233,5,26,28,26,2,1,Batch Pass 1,2022-08-10 11:35:53.393
233,5,19,78,76,2,1,Batch Pass 1,2022-08-10 11:35:53.393
233,5,2,14,14,0,7,Variance 5,2022-08-10 12:20:31.567
233,5,1,10,10,0,7,Variance 5,2022-08-10 12:20:31.567
233,5,23,68,69,-1,1,Batch Pass 1,2022-08-10 11:35:53.393
233,5,2,9,8,1,7,Variance 5,2022-08-10 12:20:31.567
233,5,1,11,10,1,1,Batch Pass 1,2022-08-10 11:35:53.393
233,5,1,12,11,1,7,Variance 5,2022-08-10 12:20:31.567
233,5,2,5,4,1,7,Variance 5,2022-08-10 12:20:31.567
233,5,2,8,10,-2,7,Variance 5,2022-08-10 12:20:31.567
233,5,4,23,24,-1,1,Batch Pass 1,2022-08-10 11:35:53.393
233,5,2,18,16,2,7,Variance 5,2022-08-10 12:20:31.567
233,5,2,17,18,-1,1,Batch Pass 1,2022-08-10 11:35:53.393
233,4,6,13,0,13,6,Variance 4,2022-08-10 10:15:38.527
233,4,35,71,70,1,1,Batch Pass 1,2022-08-10 09:27:38.513
233,4,5,25,25,0,1,Batch Pass 1,2022-08-10 09:27:38.513
233,4,1,8,8,0,1,Batch Pass 1,2022-08-10 09:27:38.513
233,4,1,10,10,0,6,Variance 4,2022-08-10 10:15:38.527
233,4,1,18,18,0,1,Batch Pass 1,2022-08-10 09:27:38.513
233,4,3,16,0,16,8,Variance 4 Supplement,2022-08-10 10:30:31.850
233,4,3,17,3,14,6,Variance 4,2022-08-10 10:15:38.527
233,4,1,8,4,4,6,Variance 4,2022-08-10 10:15:38.527
233,4,5,30,30,0,1,Batch Pass 1,2022-08-10 09:27:38.513
233,4,13,13,0,13,1,Batch Pass 1,2022-08-10 09:27:38.513
233,4,1,3,2,1,6,Variance 4,2022-08-10 10:15:38.527
233,4,18,53,54,-1,1,Batch Pass 1,2022-08-10 09:27:38.513
233,4,2,6,10,-4,6,Variance 4,2022-08-10 10:15:38.527
233,4,2,14,14,0,1,Batch Pass 1,2022-08-10 09:27:38.513
233,4,1,8,8,0,6,Variance 4,2022-08-10 10:15:38.527
233,4,91,97,91,6,1,Batch Pass 1,2022-08-10 09:27:38.513
233,4,3,12,9,3,6,Variance 4,2022-08-10 10:15:38.527
233,4,8,32,32,0,1,Batch Pass 1,2022-08-10 09:27:38.513
233,4,3,18,18,0,6,Variance 4,2022-08-10 10:15:38.527
233,4,1,11,11,0,1,Batch Pass 1,2022-08-10 09:27:38.513
233,4,1,12,12,0,6,Variance 4,2022-08-10 10:15:38.527
233,3,1,1,2,-1,5,Varaince 3,2022-08-09 12:52:03.017
233,3,12,48,48,0,1,Batch Pass 1,2022-08-09 11:50:08.103
233,3,2,14,14,0,1,Batch Pass 1,2022-08-09 11:50:08.103
233,3,1,9,9,0,5,Varaince 3,2022-08-09 12:52:03.017
233,3,3,30,30,0,1,Batch Pass 1,2022-08-09 11:50:08.103
233,3,1,7,15,-8,5,Varaince 3,2022-08-09 12:52:03.017
233,3,1,58,58,0,1,Batch Pass 1,2022-08-09 11:50:08.103
233,3,75,83,75,8,1,Batch Pass 1,2022-08-09 11:50:08.103
233,3,1,5,5,0,5,Varaince 3,2022-08-09 12:52:03.017
233,3,1,6,11,-5,5,Varaince 3,2022-08-09 12:52:03.017
233,3,1,21,21,0,5,Varaince 3,2022-08-09 12:52:03.017
233,3,1,3,1,2,5,Varaince 3,2022-08-09 12:52:03.017
233,3,27,54,54,0,1,Batch Pass 1,2022-08-09 11:50:08.103
233,3,2,11,8,3,5,Varaince 3,2022-08-09 12:52:03.017
233,3,3,15,15,0,1,Batch Pass 1,2022-08-09 11:50:08.103
233,3,13,13,0,13,1,Batch Pass 1,2022-08-09 11:50:08.103
233,3,6,17,0,17,5,Varaince 3,2022-08-09 12:52:03.017
233,3,14,42,42,0,1,Batch Pass 1,2022-08-09 11:50:08.103
233,3,1,1,3,-2,5,Varaince 3,2022-08-09 12:52:03.017
233,3,2,12,12,0,1,Batch Pass 1,2022-08-09 11:50:08.103
233,3,1,6,6,0,5,Varaince 3,2022-08-09 12:52:03.017
233,3,2,18,18,0,1,Batch Pass 1,2022-08-09 11:50:08.103
233,2,12,12,0,12,1,Batch Pass 1,2022-08-09 09:29:52.040
233,2,3,6,3,3,4,Variance 2,2022-08-09 09:57:52.380
233,2,12,36,36,0,1,Batch Pass 1,2022-08-09 09:29:52.040
233,2,3,18,12,6,4,Variance 2,2022-08-09 09:57:52.380
233,2,4,24,24,0,1,Batch Pass 1,2022-08-09 09:29:52.040
233,2,1,11,11,0,4,Variance 2,2022-08-09 09:57:52.380
233,2,101,110,101,9,1,Batch Pass 1,2022-08-09 09:29:52.040
233,2,1,3,2,1,4,Variance 2,2022-08-09 09:57:52.380
233,2,8,32,32,0,1,Batch Pass 1,2022-08-09 09:29:52.040
233,2,2,14,14,0,1,Batch Pass 1,2022-08-09 09:29:52.040
233,2,7,35,35,0,1,Batch Pass 1,2022-08-09 09:29:52.040
233,2,1,6,6,0,4,Variance 2,2022-08-09 09:57:52.380
233,2,1,11,11,0,1,Batch Pass 1,2022-08-09 09:29:52.040
233,2,1,27,25,2,4,Variance 2,2022-08-09 09:57:52.380
233,2,5,35,0,35,4,Variance 2,2022-08-09 09:57:52.380
233,2,34,67,68,-1,1,Batch Pass 1,2022-08-09 09:29:52.040
233,2,1,18,16,2,4,Variance 2,2022-08-09 09:57:52.380
233,1,1,3,1,2,3,Variance 1,2022-08-08 13:02:28.753
233,1,42,89,84,5,1,Batch Pass 1,2022-08-08 12:28:36.323
233,1,1,3,4,-1,3,Variance 1,2022-08-08 13:02:28.753
233,1,1,9,9,0,1,Batch Pass 1,2022-08-08 12:28:36.323
233,1,1,15,15,0,1,Batch Pass 1,2022-08-08 12:28:36.323
233,1,7,23,0,23,3,Variance 1,2022-08-08 13:02:28.753
233,1,5,26,25,1,1,Batch Pass 1,2022-08-08 12:28:36.323
233,1,1,7,7,0,3,Variance 1,2022-08-08 13:02:28.753
233,1,2,15,16,-1,1,Batch Pass 1,2022-08-08 12:28:36.323
233,1,1,11,11,0,1,Batch Pass 1,2022-08-08 12:28:36.323
233,1,1,14,14,0,1,Batch Pass 1,2022-08-08 12:28:36.323
233,1,98,102,98,4,1,Batch Pass 1,2022-08-08 12:28:36.323
233,1,2,7,6,1,3,Variance 1,2022-08-08 13:02:28.753
233,1,6,24,24,0,1,Batch Pass 1,2022-08-08 12:28:36.323
233,1,1,6,6,0,3,Variance 1,2022-08-08 13:02:28.753
233,1,1,7,7,0,1,Batch Pass 1,2022-08-08 12:28:36.323
233,1,1,17,17,0,1,Batch Pass 1,2022-08-08 12:28:36.323
233,1,7,7,0,7,1,Batch Pass 1,2022-08-08 12:28:36.323
233,1,11,32,33,-1,1,Batch Pass 1,2022-08-08 12:28:36.323
233,1,5,30,30,0,1,Batch Pass 1,2022-08-08 12:28:36.323
233,1,1,16,16,0,1,Batch Pass 1,2022-08-08 12:28:36.323
286,4,5,20,20,0,1,Batch Pass 1,2022-08-11 19:11:17.700
286,4,2,13,14,-1,1,Batch Pass 1,2022-08-11 19:11:17.700
286,4,9,27,27,0,1,Batch Pass 1,2022-08-11 19:11:17.700
286,4,1,6,6,0,1,Batch Pass 1,2022-08-11 19:11:17.700
286,4,13,27,26,1,1,Batch Pass 1,2022-08-11 19:11:17.700
286,4,4,20,20,0,1,Batch Pass 1,2022-08-11 19:11:17.700
286,4,1,12,12,0,1,Batch Pass 1,2022-08-11 19:11:17.700
286,4,91,97,91,6,1,Batch Pass 1,2022-08-11 19:11:17.700
286,3,92,100,92,8,1,Batch Pass 1,2022-08-10 21:54:14.077
286,3,1,10,11,-1,1,Batch Pass 1,2022-08-10 21:54:14.077
286,3,1,3,3,0,5,Varaince 3,2022-08-10 22:07:23.487
286,3,8,31,32,-1,1,Batch Pass 1,2022-08-10 21:54:14.077
286,3,1,11,10,1,1,Batch Pass 1,2022-08-10 21:54:14.077
286,3,1,4,1,3,5,Varaince 3,2022-08-10 22:07:23.487
286,3,12,37,36,1,1,Batch Pass 1,2022-08-10 21:54:14.077
286,3,1,6,6,0,1,Batch Pass 1,2022-08-10 21:54:14.077
286,3,26,51,52,-1,1,Batch Pass 1,2022-08-10 21:54:14.077
286,3,1,5,5,0,5,Varaince 3,2022-08-10 22:07:23.487
286,3,1,11,11,0,5,Varaince 3,2022-08-10 22:07:23.487
286,2,76,79,76,3,1,Batch Pass 1,2022-08-09 21:28:12.213
286,2,1,9,9,0,4,Variance 2,2022-08-09 21:49:28.380
286,2,18,40,36,4,1,Batch Pass 1,2022-08-09 21:28:12.213
286,2,4,20,20,0,1,Batch Pass 1,2022-08-09 21:28:12.213
286,2,13,40,39,1,1,Batch Pass 1,2022-08-09 21:28:12.213
286,2,3,12,12,0,4,Variance 2,2022-08-09 21:49:28.380
286,2,2,12,12,0,1,Batch Pass 1,2022-08-09 21:28:12.213
286,2,2,4,4,0,4,Variance 2,2022-08-09 21:49:28.380
286,2,4,17,16,1,1,Batch Pass 1,2022-08-09 21:28:12.213
286,2,2,10,10,0,4,Variance 2,2022-08-09 21:49:28.380
286,2,1,10,10,0,1,Batch Pass 1,2022-08-09 21:28:12.213
286,1,6,20,18,2,1,Batch Pass 1,2022-08-08 21:16:04.543
286,1,1,3,3,0,3,Variance 1,2022-08-08 21:34:43.427
286,1,2,12,12,0,1,Batch Pass 1,2022-08-08 21:16:04.543
286,1,1,9,9,0,1,Batch Pass 1,2022-08-08 21:16:04.543
286,1,1,19,19,0,1,Batch Pass 1,2022-08-08 21:16:04.543
286,1,1,19,19,0,3,Variance 1,2022-08-08 21:34:43.427
286,1,18,35,36,-1,1,Batch Pass 1,2022-08-08 21:16:04.543
286,1,2,10,10,0,1,Batch Pass 1,2022-08-08 21:16:04.543
286,1,1,6,5,1,3,Variance 1,2022-08-08 21:34:43.427
286,1,72,77,72,5,1,Batch Pass 1,2022-08-08 21:16:04.543
286,1,1,8,8,0,1,Batch Pass 1,2022-08-08 21:16:04.543
286,1,2,8,8,0,1,Batch Pass 1,2022-08-08 21:16:04.543
286,1,1,6,7,-1,3,Variance 1,2022-08-08 21:34:43.427
301,4,1,2,1,1,6,Variance 4,2022-08-12 09:38:59.610
301,4,33,65,66,-1,1,Batch Pass 1,2022-08-11 15:03:16.240
301,4,1,12,12,0,1,Batch Pass 1,2022-08-11 15:03:16.240
301,4,1,19,17,2,6,Variance 4,2022-08-12 09:38:59.610
301,4,4,4,0,4,1,Batch Pass 1,2022-08-11 15:03:16.240
301,4,5,8,0,8,6,Variance 4,2022-08-12 09:38:59.610
301,4,13,37,39,-2,1,Batch Pass 1,2022-08-11 15:03:16.240
301,4,4,24,24,0,1,Batch Pass 1,2022-08-11 15:03:16.240
301,4,174,179,174,5,1,Batch Pass 1,2022-08-11 15:03:16.240
301,4,1,8,3,5,6,Variance 4,2022-08-12 09:38:59.610
301,4,9,36,36,0,1,Batch Pass 1,2022-08-11 15:03:16.240
301,4,1,3,9,-6,6,Variance 4,2022-08-12 09:38:59.610
301,4,5,25,25,0,1,Batch Pass 1,2022-08-11 15:03:16.240
301,4,2,16,16,0,1,Batch Pass 1,2022-08-11 15:03:16.240
301,3,1,2,2,0,5,Varaince 3,2022-08-10 15:30:11.210
301,3,4,25,24,1,1,Batch Pass 1,2022-08-10 14:39:22.383
301,3,3,3,0,3,1,Batch Pass 1,2022-08-10 14:39:22.383
301,3,1,2,0,2,5,Varaince 3,2022-08-10 15:30:11.210
301,3,18,54,54,0,1,Batch Pass 1,2022-08-10 14:39:22.383
301,3,1,3,3,0,5,Varaince 3,2022-08-10 15:30:11.210
301,3,160,163,160,3,1,Batch Pass 1,2022-08-10 14:39:22.383
301,3,8,31,32,-1,1,Batch Pass 1,2022-08-10 14:39:22.383
301,3,1,4,4,0,5,Varaince 3,2022-08-10 15:30:11.210
301,3,1,7,7,0,1,Batch Pass 1,2022-08-10 14:39:22.383
301,3,1,20,20,0,1,Batch Pass 1,2022-08-10 14:39:22.383
301,3,41,79,82,-3,1,Batch Pass 1,2022-08-10 14:39:22.383
301,3,3,16,15,1,1,Batch Pass 1,2022-08-10 14:39:22.383
301,3,1,8,8,0,1,Batch Pass 1,2022-08-10 14:39:22.383
301,3,1,11,11,0,1,Batch Pass 1,2022-08-10 14:39:22.383
301,2,2,10,8,2,4,Variance 2,2022-08-09 16:31:58.750
301,2,1,10,10,0,1,Batch Pass 1,2022-08-09 16:25:52.890
301,2,150,153,150,3,1,Batch Pass 1,2022-08-09 16:25:52.890
301,2,8,31,32,-1,1,Batch Pass 1,2022-08-09 16:25:52.890
301,2,1,10,11,-1,1,Batch Pass 1,2022-08-09 16:25:52.890
301,2,38,72,76,-4,1,Batch Pass 1,2022-08-09 16:25:52.890
301,2,1,1,2,-1,4,Variance 2,2022-08-09 16:31:58.750
301,2,3,14,15,-1,1,Batch Pass 1,2022-08-09 16:25:52.890
301,2,1,24,24,0,1,Batch Pass 1,2022-08-09 16:25:52.890
301,2,19,57,57,0,1,Batch Pass 1,2022-08-09 16:25:52.890
301,2,4,24,24,0,1,Batch Pass 1,2022-08-09 16:25:52.890
301,2,1,12,12,0,1,Batch Pass 1,2022-08-09 16:25:52.890
301,1,146,146,146,0,1,Batch Pass 1,2022-08-08 17:32:01.390
301,1,5,25,25,0,1,Batch Pass 1,2022-08-08 17:32:01.390
301,1,1,14,14,0,1,Batch Pass 1,2022-08-08 17:32:01.390
301,1,29,58,58,0,1,Batch Pass 1,2022-08-08 17:32:01.390
301,1,1,15,15,0,1,Batch Pass 1,2022-08-08 17:32:01.390
301,1,23,69,69,0,1,Batch Pass 1,2022-08-08 17:32:01.390
301,1,1,5,5,0,3,Variance 1,2022-08-09 11:06:11.897
301,1,3,18,18,0,1,Batch Pass 1,2022-08-08 17:32:01.390
301,1,9,36,36,0,1,Batch Pass 1,2022-08-08 17:32:01.390
301,1,1,10,10,0,1,Batch Pass 1,2022-08-08 17:32:01.390
331,5,8,8,8,0,1,Batch Pass 1,2022-08-12 11:41:41.140
331,5,28,111,112,-1,1,Batch Pass 1,2022-08-12 11:41:41.140
331,5,2,15,14,1,1,Batch Pass 1,2022-08-12 11:41:41.140
331,5,14,27,28,-1,1,Batch Pass 1,2022-08-12 11:41:41.140
331,5,10,51,50,1,1,Batch Pass 1,2022-08-12 11:41:41.140
331,5,8,47,48,-1,1,Batch Pass 1,2022-08-12 11:41:41.140
331,5,2,18,18,0,1,Batch Pass 1,2022-08-12 11:41:41.140
331,5,29,87,87,0,1,Batch Pass 1,2022-08-12 11:41:41.140
331,5,3,31,30,1,1,Batch Pass 1,2022-08-12 11:41:41.140
331,4,1,4,1,3,6,Variance 4,2022-08-11 17:26:37.340
331,4,7,36,35,1,1,Batch Pass 1,2022-08-11 16:23:43.840
331,4,1,8,8,0,1,Batch Pass 1,2022-08-11 16:23:43.840
331,4,1,11,11,0,1,Batch Pass 1,2022-08-11 16:23:43.840
331,4,34,63,68,-5,1,Batch Pass 1,2022-08-11 16:23:43.840
331,4,4,9,8,1,6,Variance 4,2022-08-11 17:26:37.340
331,4,1,18,18,0,1,Batch Pass 1,2022-08-11 16:23:43.840
331,4,9,9,0,9,1,Batch Pass 1,2022-08-11 16:23:43.840
331,4,3,12,0,12,6,Variance 4,2022-08-11 17:26:37.340
331,4,2,4,0,4,8,Variance 4 Supplement,2022-08-12 10:05:27.967
331,4,21,63,63,0,1,Batch Pass 1,2022-08-11 16:23:43.840
331,4,3,7,9,-2,6,Variance 4,2022-08-11 17:26:37.340
331,4,1,7,6,1,1,Batch Pass 1,2022-08-11 16:23:43.840
331,4,1,6,6,0,6,Variance 4,2022-08-11 17:26:37.340
331,4,174,178,174,4,1,Batch Pass 1,2022-08-11 16:23:43.840
331,4,6,24,24,0,1,Batch Pass 1,2022-08-11 16:23:43.840
331,4,1,7,7,0,1,Batch Pass 1,2022-08-11 16:23:43.840
331,4,1,8,10,-2,6,Variance 4,2022-08-11 17:26:37.340
331,3,29,55,58,-3,1,Batch Pass 1,2022-08-10 14:38:42.380
331,3,5,15,15,0,5,Varaince 3,2022-08-10 15:10:53.713
331,3,12,48,48,0,1,Batch Pass 1,2022-08-10 14:38:42.380
331,3,2,6,12,-6,5,Varaince 3,2022-08-10 15:10:53.713
331,3,1,4,2,2,5,Varaince 3,2022-08-10 15:10:53.713
331,3,9,46,45,1,1,Batch Pass 1,2022-08-10 14:38:42.380
331,3,1,4,8,-4,5,Varaince 3,2022-08-10 15:10:53.713
331,3,11,11,0,11,1,Batch Pass 1,2022-08-10 14:38:42.380
331,3,1,2,1,1,5,Varaince 3,2022-08-10 15:10:53.713
331,3,20,59,60,-1,1,Batch Pass 1,2022-08-10 14:38:42.380
331,3,2,5,8,-3,5,Varaince 3,2022-08-10 15:10:53.713
331,3,2,12,12,0,1,Batch Pass 1,2022-08-10 14:38:42.380
331,3,4,22,0,22,5,Varaince 3,2022-08-10 15:10:53.713
331,3,173,178,173,5,1,Batch Pass 1,2022-08-10 14:38:42.380
331,3,1,8,7,1,1,Batch Pass 1,2022-08-10 14:38:42.380
331,2,3,10,0,10,4,Variance 2,2022-08-09 16:48:12.987
331,2,157,164,157,7,1,Batch Pass 1,2022-08-09 16:25:03.950
331,2,4,16,16,0,1,Batch Pass 1,2022-08-09 16:25:03.950
331,2,1,10,10,0,4,Variance 2,2022-08-09 16:48:12.987
331,2,10,10,0,10,1,Batch Pass 1,2022-08-09 16:25:03.950
331,2,1,5,3,2,4,Variance 2,2022-08-09 16:48:12.987
331,2,1,7,7,0,1,Batch Pass 1,2022-08-09 16:25:03.950
331,2,1,4,9,-5,4,Variance 2,2022-08-09 16:48:12.987
331,2,1,24,22,2,4,Variance 2,2022-08-09 16:48:12.987
331,2,2,4,4,0,4,Variance 2,2022-08-09 16:48:12.987
331,2,19,59,57,2,1,Batch Pass 1,2022-08-09 16:25:03.950
331,2,3,18,18,0,1,Batch Pass 1,2022-08-09 16:25:03.950
331,2,1,7,8,-1,4,Variance 2,2022-08-09 16:48:12.987
331,2,2,18,18,0,1,Batch Pass 1,2022-08-09 16:25:03.950
331,2,37,76,74,2,1,Batch Pass 1,2022-08-09 16:25:03.950
331,2,1,4,4,0,4,Variance 2,2022-08-09 16:48:12.987
331,2,5,25,25,0,1,Batch Pass 1,2022-08-09 16:25:03.950
331,2,1,8,8,0,1,Batch Pass 1,2022-08-09 16:25:03.950
331,1,174,179,174,5,1,Batch Pass 1,2022-08-08 16:11:07.717
331,1,14,56,56,0,1,Batch Pass 1,2022-08-08 16:11:07.717
331,1,1,5,12,-7,3,Variance 1,2022-08-08 16:48:30.000
331,1,8,19,0,19,3,Variance 1,2022-08-08 16:48:30.000
331,1,35,64,70,-6,1,Batch Pass 1,2022-08-08 16:11:07.717
331,1,2,4,6,-2,3,Variance 1,2022-08-08 16:48:30.000
331,1,1,8,8,0,1,Batch Pass 1,2022-08-08 16:11:07.717
331,1,1,22,21,1,1,Batch Pass 1,2022-08-08 16:11:07.717
331,1,19,56,57,-1,1,Batch Pass 1,2022-08-08 16:11:07.717
331,1,1,4,4,0,3,Variance 1,2022-08-08 16:48:30.000
331,1,4,37,36,1,1,Batch Pass 1,2022-08-08 16:11:07.717
331,1,14,14,0,14,1,Batch Pass 1,2022-08-08 16:11:07.717
487,1,4,4,0,4,1,Batch Pass 1,2022-08-08 14:40:56.623
487,1,5,15,0,15,3,Variance 1,2022-08-08 15:57:42.543
487,1,6,24,24,0,1,Batch Pass 1,2022-08-08 14:40:56.623
487,1,1,7,7,0,1,Batch Pass 1,2022-08-08 14:40:56.623
487,1,36,39,36,3,1,Batch Pass 1,2022-08-08 14:40:56.623
487,1,1,3,1,2,3,Variance 1,2022-08-08 15:57:42.543
487,1,12,24,24,0,1,Batch Pass 1,2022-08-08 14:40:56.623
487,1,2,8,4,4,3,Variance 1,2022-08-08 15:57:42.543
487,1,2,10,10,0,1,Batch Pass 1,2022-08-08 14:40:56.623
487,1,1,12,50,-38,3,Variance 1,2022-08-08 15:57:42.543
487,1,8,25,24,1,1,Batch Pass 1,2022-08-08 14:40:56.623
487,1,2,8,6,2,3,Variance 1,2022-08-08 15:57:42.543
487,1,2,12,12,0,1,Batch Pass 1,2022-08-08 14:40:56.623
487,1,1,9,9,0,1,Batch Pass 1,2022-08-08 14:40:56.623
524,5,1,5,5,0,7,Variance 5,2022-08-12 10:47:37.473
524,5,6,36,36,0,1,Batch Pass 1,2022-08-12 10:17:44.807
524,5,1,9,9,0,1,Batch Pass 1,2022-08-12 10:17:44.807
524,5,1,12,12,0,1,Batch Pass 1,2022-08-12 10:17:44.807
524,5,4,9,8,1,7,Variance 5,2022-08-12 10:47:37.473
524,5,26,79,78,1,1,Batch Pass 1,2022-08-12 10:17:44.807
524,5,1,9,9,0,7,Variance 5,2022-08-12 10:47:37.473
524,5,1,10,10,0,1,Batch Pass 1,2022-08-12 10:17:44.807
524,5,69,74,69,5,1,Batch Pass 1,2022-08-12 10:17:44.807
524,5,2,7,6,1,7,Variance 5,2022-08-12 10:47:37.473
524,5,21,85,84,1,1,Batch Pass 1,2022-08-12 10:17:44.807
524,5,1,6,6,0,7,Variance 5,2022-08-12 10:47:37.473
524,5,4,29,28,1,1,Batch Pass 1,2022-08-12 10:17:44.807
524,5,1,4,1,3,7,Variance 5,2022-08-12 10:47:37.473
524,5,33,69,66,3,1,Batch Pass 1,2022-08-12 10:17:44.807
524,5,4,15,16,-1,7,Variance 5,2022-08-12 10:47:37.473
524,5,10,51,50,1,1,Batch Pass 1,2022-08-12 10:17:44.807
524,5,2,10,14,-4,7,Variance 5,2022-08-12 10:47:37.473
524,5,3,24,24,0,1,Batch Pass 1,2022-08-12 10:17:44.807
524,4,5,5,0,5,1,Batch Pass 1,2022-08-11 15:09:11.977
524,4,8,14,0,14,6,Variance 4,2022-08-11 16:02:24.110
524,4,2,6,6,0,6,Variance 4,2022-08-11 16:02:24.110
524,4,1,2,6,-4,6,Variance 4,2022-08-11 16:02:24.110
524,4,3,22,21,1,1,Batch Pass 1,2022-08-11 15:09:11.977
524,4,1,23,23,0,1,Batch Pass 1,2022-08-11 15:09:11.977
524,4,3,8,6,2,6,Variance 4,2022-08-11 16:02:24.110
524,4,25,74,75,-1,1,Batch Pass 1,2022-08-11 15:09:11.977
524,4,3,18,18,0,1,Batch Pass 1,2022-08-11 15:09:11.977
524,4,1,9,9,0,1,Batch Pass 1,2022-08-11 15:09:11.977
524,4,2,5,2,3,6,Variance 4,2022-08-11 16:02:24.110
524,4,35,70,70,0,1,Batch Pass 1,2022-08-11 15:09:11.977
524,4,6,30,30,0,1,Batch Pass 1,2022-08-11 15:09:11.977
524,4,1,9,8,1,1,Batch Pass 1,2022-08-11 15:09:11.977
524,4,1,8,8,0,6,Variance 4,2022-08-11 16:02:24.110
524,4,115,116,115,1,1,Batch Pass 1,2022-08-11 15:09:11.977
524,4,8,33,32,1,1,Batch Pass 1,2022-08-11 15:09:11.977
524,4,2,8,8,0,6,Variance 4,2022-08-11 16:02:24.110
524,3,4,23,24,-1,1,Batch Pass 1,2022-08-10 14:17:57.980
524,3,1,11,8,3,5,Varaince 3,2022-08-10 14:45:24.660
524,3,1,10,9,1,1,Batch Pass 1,2022-08-10 14:17:57.980
524,3,1,12,12,0,1,Batch Pass 1,2022-08-10 14:17:57.980
524,3,1,23,22,1,1,Batch Pass 1,2022-08-10 14:17:57.980
524,3,5,5,0,5,1,Batch Pass 1,2022-08-10 14:17:57.980
524,3,15,45,45,0,1,Batch Pass 1,2022-08-10 14:17:57.980
524,3,3,9,9,0,5,Varaince 3,2022-08-10 14:45:24.660
524,3,1,6,6,0,5,Varaince 3,2022-08-10 14:45:24.660
524,3,1,9,10,-1,1,Batch Pass 1,2022-08-10 14:17:57.980
524,3,4,11,0,11,5,Varaince 3,2022-08-10 14:45:24.660
524,3,115,120,115,5,1,Batch Pass 1,2022-08-10 14:17:57.980
524,3,12,48,48,0,1,Batch Pass 1,2022-08-10 14:17:57.980
524,3,2,14,14,0,1,Batch Pass 1,2022-08-10 14:17:57.980
524,3,1,8,7,1,5,Varaince 3,2022-08-10 14:45:24.660
524,3,1,3,1,2,5,Varaince 3,2022-08-10 14:45:24.660
524,3,31,63,62,1,1,Batch Pass 1,2022-08-10 14:17:57.980
524,3,1,4,4,0,5,Varaince 3,2022-08-10 14:45:24.660
524,3,6,31,30,1,1,Batch Pass 1,2022-08-10 14:17:57.980
524,3,2,18,16,2,1,Batch Pass 1,2022-08-10 14:17:57.980
524,2,52,104,104,0,1,Batch Pass 1,2022-08-09 12:59:32.100
524,2,1,5,5,0,1,Batch Pass 1,2022-08-09 12:59:32.100
524,2,1,8,7,1,4,Variance 2,2022-08-09 13:20:46.123
524,2,117,122,117,5,1,Batch Pass 1,2022-08-09 12:59:32.100
524,2,1,3,1,2,4,Variance 2,2022-08-09 13:20:46.123
524,2,15,60,60,0,1,Batch Pass 1,2022-08-09 12:59:32.100
524,2,10,10,0,10,1,Batch Pass 1,2022-08-09 12:59:32.100
524,2,2,12,4,8,4,Variance 2,2022-08-09 13:20:46.123
524,2,1,3,5,-2,4,Variance 2,2022-08-09 13:20:46.123
524,2,2,14,14,0,1,Batch Pass 1,2022-08-09 12:59:32.100
524,2,1,10,10,0,1,Batch Pass 1,2022-08-09 12:59:32.100
524,2,5,9,0,9,4,Variance 2,2022-08-09 13:20:46.123
524,2,24,71,72,-1,1,Batch Pass 1,2022-08-09 12:59:32.100
524,2,2,8,6,2,4,Variance 2,2022-08-09 13:20:46.123
524,2,4,24,24,0,1,Batch Pass 1,2022-08-09 12:59:32.100
524,2,1,9,9,0,1,Batch Pass 1,2022-08-09 12:59:32.100
524,1,1,7,1,6,3,Variance 1,2022-08-08 16:06:12.100
524,1,25,51,50,1,1,Batch Pass 1,2022-08-08 15:38:27.220
524,1,5,24,25,-1,1,Batch Pass 1,2022-08-08 15:38:27.220
524,1,1,6,8,-2,3,Variance 1,2022-08-08 16:06:12.100
524,1,129,135,129,6,1,Batch Pass 1,2022-08-08 15:38:27.220
524,1,1,5,5,0,3,Variance 1,2022-08-08 16:06:12.100
524,1,2,22,22,0,1,Batch Pass 1,2022-08-08 15:38:27.220
524,1,2,5,0,5,3,Variance 1,2022-08-08 16:06:12.100
524,1,3,12,9,3,3,Variance 1,2022-08-08 16:06:12.100
524,1,10,40,40,0,1,Batch Pass 1,2022-08-08 15:38:27.220
524,1,2,14,14,0,1,Batch Pass 1,2022-08-08 15:38:27.220
524,1,2,20,20,0,1,Batch Pass 1,2022-08-08 15:38:27.220
524,1,8,8,0,8,1,Batch Pass 1,2022-08-08 15:38:27.220
524,1,26,77,78,-1,1,Batch Pass 1,2022-08-08 15:38:27.220
524,1,1,2,4,-2,3,Variance 1,2022-08-08 16:06:12.100
524,1,3,19,18,1,1,Batch Pass 1,2022-08-08 15:38:27.220
524,1,1,9,7,2,3,Variance 1,2022-08-08 16:06:12.100
524,1,1,9,9,0,1,Batch Pass 1,2022-08-08 15:38:27.220
524,1,1,10,13,-3,3,Variance 1,2022-08-08 16:06:12.100
653,4,104,106,104,2,1,Batch Pass 1,2022-08-11 14:15:28.307
653,4,5,12,10,2,6,Variance 4,2022-08-11 15:40:10.630
653,4,6,24,24,0,1,Batch Pass 1,2022-08-11 14:15:28.307
653,4,2,11,10,1,6,Variance 4,2022-08-11 15:40:10.630
653,4,2,15,14,1,1,Batch Pass 1,2022-08-11 14:15:28.307
653,4,1,8,8,0,6,Variance 4,2022-08-11 15:40:10.630
653,4,22,47,44,3,1,Batch Pass 1,2022-08-11 14:15:28.307
653,4,3,16,15,1,1,Batch Pass 1,2022-08-11 14:15:28.307
653,4,2,14,12,2,6,Variance 4,2022-08-11 15:40:10.630
653,4,1,8,8,0,1,Batch Pass 1,2022-08-11 14:15:28.307
653,4,11,26,0,26,6,Variance 4,2022-08-11 15:40:10.630
653,4,7,28,21,7,6,Variance 4,2022-08-11 15:40:10.630
653,4,2,12,12,0,1,Batch Pass 1,2022-08-11 14:15:28.307
653,4,1,4,7,-3,6,Variance 4,2022-08-11 15:40:10.630
653,4,2,24,24,0,1,Batch Pass 1,2022-08-11 14:15:28.307
653,4,29,29,0,29,1,Batch Pass 1,2022-08-11 14:15:28.307
653,4,6,14,6,8,6,Variance 4,2022-08-11 15:40:10.630
653,4,17,53,51,2,1,Batch Pass 1,2022-08-11 14:15:28.307
653,4,4,17,16,1,6,Variance 4,2022-08-11 15:40:10.630
653,3,21,21,0,21,1,Batch Pass 1,2022-08-10 12:17:33.687
653,3,5,16,10,6,5,Varaince 3,2022-08-10 13:27:15.330
653,3,2,8,10,-2,5,Varaince 3,2022-08-10 13:27:15.330
653,3,1,6,7,-1,1,Batch Pass 1,2022-08-10 12:17:33.687
653,3,1,10,10,0,1,Batch Pass 1,2022-08-10 12:17:33.687
653,3,1,13,13,0,1,Batch Pass 1,2022-08-10 12:17:33.687
653,3,117,123,117,6,1,Batch Pass 1,2022-08-10 12:17:33.687
653,3,3,7,3,4,5,Varaince 3,2022-08-10 13:27:15.330
653,3,8,33,32,1,1,Batch Pass 1,2022-08-10 12:17:33.687
653,3,4,15,16,-1,5,Varaince 3,2022-08-10 13:27:15.330
653,3,1,8,8,0,5,Varaince 3,2022-08-10 13:27:15.330
653,3,16,40,0,40,5,Varaince 3,2022-08-10 13:27:15.330
653,3,33,63,66,-3,1,Batch Pass 1,2022-08-10 12:17:33.687
653,3,3,16,15,1,1,Batch Pass 1,2022-08-10 12:17:33.687
653,3,2,17,16,1,1,Batch Pass 1,2022-08-10 12:17:33.687
653,3,13,37,39,-2,1,Batch Pass 1,2022-08-10 12:17:33.687
653,3,3,11,9,2,5,Varaince 3,2022-08-10 13:27:15.330
653,3,4,25,24,1,1,Batch Pass 1,2022-08-10 12:17:33.687
653,2,30,30,0,30,1,Batch Pass 1,2022-08-09 12:31:37.177
653,2,16,50,48,2,1,Batch Pass 1,2022-08-09 12:31:37.177
653,2,2,8,8,0,4,Variance 2,2022-08-09 13:59:40.020
653,2,1,6,6,0,1,Batch Pass 1,2022-08-09 12:31:37.177
653,2,133,141,133,8,1,Batch Pass 1,2022-08-09 12:31:37.177
653,2,2,5,2,3,4,Variance 2,2022-08-09 13:59:40.020
653,2,12,47,48,-1,1,Batch Pass 1,2022-08-09 12:31:37.177
653,2,1,7,7,0,1,Batch Pass 1,2022-08-09 12:31:37.177
653,2,1,20,20,0,1,Batch Pass 1,2022-08-09 12:31:37.177
653,2,7,16,14,2,4,Variance 2,2022-08-09 13:59:40.020
653,2,5,25,25,0,1,Batch Pass 1,2022-08-09 12:31:37.177
653,2,2,11,10,1,4,Variance 2,2022-08-09 13:59:40.020
653,2,14,32,0,32,4,Variance 2,2022-08-09 13:59:40.020
653,2,30,59,60,-1,1,Batch Pass 1,2022-08-09 12:31:37.177
653,2,5,11,15,-4,4,Variance 2,2022-08-09 13:59:40.020
653,2,1,6,6,0,4,Variance 2,2022-08-09 13:59:40.020
653,1,15,15,0,15,1,Batch Pass 1,2022-08-08 15:51:12.937
653,1,3,8,6,2,3,Variance 1,2022-08-08 16:42:13.883
653,1,10,29,30,-1,1,Batch Pass 1,2022-08-08 15:51:12.937
653,1,1,6,5,1,3,Variance 1,2022-08-08 16:42:13.883
653,1,6,36,36,0,1,Batch Pass 1,2022-08-08 15:51:12.937
653,1,1,21,21,0,3,Variance 1,2022-08-08 16:42:13.883
653,1,2,3,2,1,3,Variance 1,2022-08-08 16:42:13.883
653,1,30,60,60,0,1,Batch Pass 1,2022-08-08 15:51:12.937
653,1,3,16,12,4,3,Variance 1,2022-08-08 16:42:13.883
653,1,2,19,18,1,1,Batch Pass 1,2022-08-08 15:51:12.937
653,1,13,28,0,28,3,Variance 1,2022-08-08 16:42:13.883
653,1,5,25,25,0,1,Batch Pass 1,2022-08-08 15:51:12.937
653,1,1,7,7,0,3,Variance 1,2022-08-08 16:42:13.883
653,1,115,117,115,2,1,Batch Pass 1,2022-08-08 15:51:12.937
653,1,5,19,15,4,3,Variance 1,2022-08-08 16:42:13.883
653,1,9,38,36,2,1,Batch Pass 1,2022-08-08 15:51:12.937
653,1,2,14,14,0,1,Batch Pass 1,2022-08-08 15:51:12.937
663,4,106,116,106,10,1,Batch Pass 1,2022-08-11 15:09:41.680
663,4,1,4,3,1,6,Variance 4,2022-08-11 15:44:04.480
663,4,1,11,11,0,1,Batch Pass 1,2022-08-11 15:09:41.680
663,4,28,56,56,0,1,Batch Pass 1,2022-08-11 15:09:41.680
663,4,2,9,10,-1,1,Batch Pass 1,2022-08-11 15:09:41.680
663,4,2,7,2,5,6,Variance 4,2022-08-11 15:44:04.480
663,4,21,64,63,1,1,Batch Pass 1,2022-08-11 15:09:41.680
663,4,3,14,12,2,6,Variance 4,2022-08-11 15:44:04.480
663,4,2,12,12,0,1,Batch Pass 1,2022-08-11 15:09:41.680
663,4,2,6,4,2,6,Variance 4,2022-08-11 15:44:04.480
663,4,12,51,48,3,1,Batch Pass 1,2022-08-11 15:09:41.680
663,4,1,7,7,0,1,Batch Pass 1,2022-08-11 15:09:41.680
663,4,1,20,20,0,1,Batch Pass 1,2022-08-11 15:09:41.680
663,3,3,16,6,10,5,Varaince 3,2022-08-10 18:16:56.980
663,3,5,21,20,1,1,Batch Pass 1,2022-08-10 17:01:40.837
663,3,1,7,7,0,1,Batch Pass 1,2022-08-10 17:01:40.837
663,3,1,25,26,-1,1,Batch Pass 1,2022-08-10 17:01:40.837
663,3,108,122,108,14,1,Batch Pass 1,2022-08-10 17:01:40.837
663,3,3,14,3,11,5,Varaince 3,2022-08-10 18:16:56.980
663,3,1,9,8,1,1,Batch Pass 1,2022-08-10 17:01:40.837
663,3,28,60,56,4,1,Batch Pass 1,2022-08-10 17:01:40.837
663,3,1,5,5,0,1,Batch Pass 1,2022-08-10 17:01:40.837
663,3,1,15,15,0,1,Batch Pass 1,2022-08-10 17:01:40.837
663,3,12,36,36,0,1,Batch Pass 1,2022-08-10 17:01:40.837
663,3,2,6,6,0,5,Varaince 3,2022-08-10 18:16:56.980
663,3,1,6,6,0,1,Batch Pass 1,2022-08-10 17:01:40.837
663,2,1,1,0,1,1,Batch Pass 1,2022-08-09 15:13:40.663
663,2,2,9,2,7,4,Variance 2,2022-08-09 15:47:40.267
663,2,4,28,28,0,1,Batch Pass 1,2022-08-09 15:13:40.663
663,2,56,63,56,7,1,Batch Pass 1,2022-08-09 15:13:40.663
663,2,3,13,12,1,1,Batch Pass 1,2022-08-09 15:13:40.663
663,2,25,55,50,5,1,Batch Pass 1,2022-08-09 15:13:40.663
663,2,3,14,6,8,4,Variance 2,2022-08-09 15:47:40.267
663,2,4,19,20,-1,1,Batch Pass 1,2022-08-09 15:13:40.663
663,2,19,57,57,0,1,Batch Pass 1,2022-08-09 15:13:40.663
663,2,2,12,12,0,1,Batch Pass 1,2022-08-09 15:13:40.663
663,2,1,11,12,-1,1,Batch Pass 1,2022-08-09 15:13:40.663
663,1,87,94,87,7,1,Batch Pass 1,2022-08-08 16:17:48.847
663,1,5,17,5,12,3,Variance 1,2022-08-08 17:29:22.743
663,1,5,20,20,0,1,Batch Pass 1,2022-08-08 16:17:48.847
663,1,24,47,48,-1,1,Batch Pass 1,2022-08-08 16:17:48.847
663,1,4,15,8,7,3,Variance 1,2022-08-08 17:29:22.743
663,1,4,24,20,4,1,Batch Pass 1,2022-08-08 16:17:48.847
663,1,15,48,45,3,1,Batch Pass 1,2022-08-08 16:17:48.847
663,1,4,19,12,7,3,Variance 1,2022-08-08 17:29:22.743
663,1,2,12,12,0,1,Batch Pass 1,2022-08-08 16:17:48.847
663,1,6,6,0,6,1,Batch Pass 1,2022-08-08 16:17:48.847
663,1,1,10,4,6,3,Variance 1,2022-08-08 17:29:22.743
723,4,9,16,0,16,8,Variance 4 Supplement,2022-08-12 11:37:26.090
723,4,1,3,3,0,8,Variance 4 Supplement,2022-08-12 11:37:26.090
723,4,3,12,12,0,6,Variance 4,2022-08-11 16:43:31.107
723,4,1,6,6,0,1,Batch Pass 1,2022-08-11 15:46:05.373
723,4,1,14,7,7,6,Variance 4,2022-08-11 16:43:31.107
723,4,25,50,50,0,1,Batch Pass 1,2022-08-11 15:46:05.373
723,4,1,2,2,0,8,Variance 4 Supplement,2022-08-12 11:37:26.090
723,4,4,20,20,0,1,Batch Pass 1,2022-08-11 15:46:05.373
723,4,1,6,6,0,6,Variance 4,2022-08-11 16:43:31.107
723,4,1,5,9,-4,6,Variance 4,2022-08-11 16:43:31.107
723,4,1,37,37,0,1,Batch Pass 1,2022-08-11 15:46:05.373
723,4,105,112,105,7,1,Batch Pass 1,2022-08-11 15:46:05.373
723,4,2,6,4,2,6,Variance 4,2022-08-11 16:43:31.107
723,4,7,29,28,1,1,Batch Pass 1,2022-08-11 15:46:05.373
723,4,2,11,10,1,6,Variance 4,2022-08-11 16:43:31.107
723,4,1,21,18,3,6,Variance 4,2022-08-11 16:43:31.107
723,4,2,5,2,3,6,Variance 4,2022-08-11 16:43:31.107
723,4,19,59,57,2,1,Batch Pass 1,2022-08-11 15:46:05.373
723,4,1,4,4,0,8,Variance 4 Supplement,2022-08-12 11:37:26.090
723,4,1,4,8,-4,6,Variance 4,2022-08-11 16:43:31.107
723,4,1,33,33,0,6,Variance 4,2022-08-11 16:43:31.107
723,3,15,15,0,15,1,Batch Pass 1,2022-08-10 14:24:42.167
723,3,2,3,2,1,5,Varaince 3,2022-08-10 15:39:00.827
723,3,18,58,54,4,1,Batch Pass 1,2022-08-10 14:24:42.167
723,3,3,18,18,0,1,Batch Pass 1,2022-08-10 14:24:42.167
723,3,1,8,8,0,5,Varaince 3,2022-08-10 15:39:00.827
723,3,1,14,14,0,5,Varaince 3,2022-08-10 15:39:00.827
723,3,5,20,20,0,1,Batch Pass 1,2022-08-10 14:24:42.167
723,3,1,6,4,2,5,Varaince 3,2022-08-10 15:39:00.827
723,3,1,7,7,0,1,Batch Pass 1,2022-08-10 14:24:42.167
723,3,3,7,0,7,5,Varaince 3,2022-08-10 15:39:00.827
723,3,105,112,105,7,1,Batch Pass 1,2022-08-10 14:24:42.167
723,3,4,13,12,1,5,Varaince 3,2022-08-10 15:39:00.827
723,3,2,11,12,-1,5,Varaince 3,2022-08-10 15:39:00.827
723,3,2,22,22,0,1,Batch Pass 1,2022-08-10 14:24:42.167
723,3,41,82,82,0,1,Batch Pass 1,2022-08-10 14:24:42.167
723,3,5,11,10,1,5,Varaince 3,2022-08-10 15:39:00.827
723,3,6,29,30,-1,1,Batch Pass 1,2022-08-10 14:24:42.167
723,3,4,28,20,8,5,Varaince 3,2022-08-10 15:39:00.827
723,2,7,36,35,1,1,Batch Pass 1,2022-08-09 16:45:18.850
723,2,30,64,60,4,1,Batch Pass 1,2022-08-09 16:45:18.850
723,2,1,6,6,0,4,Variance 2,2022-08-09 17:31:00.247
723,2,1,9,9,0,1,Batch Pass 1,2022-08-09 16:45:18.850
723,2,1,12,12,0,1,Batch Pass 1,2022-08-09 16:45:18.850
723,2,1,32,25,7,4,Variance 2,2022-08-09 17:31:00.247
723,2,8,8,0,8,1,Batch Pass 1,2022-08-09 16:45:18.850
723,2,6,21,0,21,4,Variance 2,2022-08-09 17:31:00.247
723,2,16,48,48,0,1,Batch Pass 1,2022-08-09 16:45:18.850
723,2,3,14,9,5,4,Variance 2,2022-08-09 17:31:00.247
723,2,2,12,12,0,1,Batch Pass 1,2022-08-09 16:45:18.850
723,2,111,121,111,10,1,Batch Pass 1,2022-08-09 16:45:18.850
723,2,1,3,1,2,4,Variance 2,2022-08-09 17:31:00.247
723,2,7,29,28,1,1,Batch Pass 1,2022-08-09 16:45:18.850
723,2,4,17,16,1,4,Variance 2,2022-08-09 17:31:00.247
723,2,3,23,21,2,1,Batch Pass 1,2022-08-09 16:45:18.850
723,2,2,11,14,-3,4,Variance 2,2022-08-09 17:31:00.247
723,1,132,139,132,7,1,Batch Pass 1,2022-08-08 18:38:17.823
723,1,1,4,1,3,3,Variance 1,2022-08-08 19:20:43.230
723,1,1,4,4,0,3,Variance 1,2022-08-08 19:20:43.230
723,1,29,61,58,3,1,Batch Pass 1,2022-08-08 18:38:17.823
723,1,2,6,6,0,3,Variance 1,2022-08-08 19:20:43.230
723,1,6,30,30,0,1,Batch Pass 1,2022-08-08 18:38:17.823
723,1,1,12,12,0,1,Batch Pass 1,2022-08-08 18:38:17.823
723,1,17,51,51,0,1,Batch Pass 1,2022-08-08 18:38:17.823
723,1,1,6,6,0,1,Batch Pass 1,2022-08-08 18:38:17.823
723,1,3,13,18,-5,3,Variance 1,2022-08-08 19:20:43.230
723,1,1,9,9,0,3,Variance 1,2022-08-08 19:20:43.230
723,1,1,12,12,0,3,Variance 1,2022-08-08 19:20:43.230
723,1,7,16,14,2,3,Variance 1,2022-08-08 19:20:43.230
723,1,12,49,48,1,1,Batch Pass 1,2022-08-08 18:38:17.823
723,1,1,7,7,0,1,Batch Pass 1,2022-08-08 18:38:17.823
723,1,2,12,16,-4,3,Variance 1,2022-08-08 19:20:43.230
756,4,101,108,101,7,1,Batch Pass 1,2022-08-11 14:37:41.183
756,4,2,10,4,6,6,Variance 4,2022-08-11 14:54:45.880
756,4,9,37,36,1,1,Batch Pass 1,2022-08-11 14:37:41.183
756,4,2,13,10,3,6,Variance 4,2022-08-11 14:54:45.880
756,4,2,14,14,0,1,Batch Pass 1,2022-08-11 14:37:41.183
756,4,2,4,2,2,6,Variance 4,2022-08-11 14:54:45.880
756,4,19,40,38,2,1,Batch Pass 1,2022-08-11 14:37:41.183
756,4,4,21,20,1,1,Batch Pass 1,2022-08-11 14:37:41.183
756,4,1,6,4,2,6,Variance 4,2022-08-11 14:54:45.880
756,4,6,37,36,1,1,Batch Pass 1,2022-08-11 14:37:41.183
756,4,15,15,0,15,1,Batch Pass 1,2022-08-11 14:37:41.183
756,4,17,51,0,51,6,Variance 4,2022-08-11 14:54:45.880
756,4,3,13,0,13,8,Variance 4 Supplement,2022-08-11 15:00:18.660
756,4,21,68,63,5,1,Batch Pass 1,2022-08-11 14:37:41.183
756,4,4,25,12,13,6,Variance 4,2022-08-11 14:54:45.880
756,4,1,8,9,-1,6,Variance 4,2022-08-11 14:54:45.880
756,4,1,10,10,0,1,Batch Pass 1,2022-08-11 14:37:41.183
756,3,27,56,54,2,1,Batch Pass 1,2022-08-10 15:26:36.530
756,3,6,32,30,2,1,Batch Pass 1,2022-08-10 15:26:36.530
756,3,4,33,32,1,1,Batch Pass 1,2022-08-10 15:26:36.530
756,3,4,16,8,8,5,Varaince 3,2022-08-10 15:47:15.827
756,3,1,7,5,2,5,Varaince 3,2022-08-10 15:47:15.827
756,3,1,6,6,0,1,Batch Pass 1,2022-08-10 15:26:36.530
756,3,1,12,12,0,1,Batch Pass 1,2022-08-10 15:26:36.530
756,3,28,28,0,28,1,Batch Pass 1,2022-08-10 15:26:36.530
756,3,6,20,6,14,5,Varaince 3,2022-08-10 15:47:15.827
756,3,10,32,30,2,1,Batch Pass 1,2022-08-10 15:26:36.530
756,3,1,2,4,-2,5,Varaince 3,2022-08-10 15:47:15.827
756,3,14,37,0,37,5,Varaince 3,2022-08-10 15:47:15.827
756,3,106,113,106,7,1,Batch Pass 1,2022-08-10 15:26:36.530
756,3,3,15,9,6,5,Varaince 3,2022-08-10 15:47:15.827
756,3,7,28,28,0,1,Batch Pass 1,2022-08-10 15:26:36.530
756,3,1,7,7,0,1,Batch Pass 1,2022-08-10 15:26:36.530
756,3,2,23,20,3,5,Varaince 3,2022-08-10 15:47:15.827
756,2,26,53,52,1,1,Batch Pass 1,2022-08-09 16:42:36.640
756,2,2,6,8,-2,4,Variance 2,2022-08-09 17:14:50.627
756,2,7,37,35,2,1,Batch Pass 1,2022-08-09 16:42:36.640
756,2,2,16,14,2,4,Variance 2,2022-08-09 17:14:50.627
756,2,2,17,16,1,1,Batch Pass 1,2022-08-09 16:42:36.640
756,2,1,15,13,2,4,Variance 2,2022-08-09 17:14:50.627
756,2,10,20,0,20,4,Variance 2,2022-08-09 17:14:50.627
756,2,95,100,95,5,1,Batch Pass 1,2022-08-09 16:42:36.640
756,2,4,9,12,-3,4,Variance 2,2022-08-09 17:14:50.627
756,2,9,38,36,2,1,Batch Pass 1,2022-08-09 16:42:36.640
756,2,1,11,11,0,1,Batch Pass 1,2022-08-09 16:42:36.640
756,2,26,26,0,26,1,Batch Pass 1,2022-08-09 16:42:36.640
756,2,5,18,10,8,4,Variance 2,2022-08-09 17:14:50.627
756,2,1,5,5,0,4,Variance 2,2022-08-09 17:14:50.627
756,2,2,17,14,3,1,Batch Pass 1,2022-08-09 16:42:36.640
756,2,1,20,20,0,1,Batch Pass 1,2022-08-09 16:42:36.640
756,2,7,18,7,11,4,Variance 2,2022-08-09 17:14:50.627
756,2,12,36,36,0,1,Batch Pass 1,2022-08-09 16:42:36.640
756,2,2,12,12,0,1,Batch Pass 1,2022-08-09 16:42:36.640
756,2,1,3,8,-5,4,Variance 2,2022-08-09 17:14:50.627
756,2,1,8,11,-3,4,Variance 2,2022-08-09 17:14:50.627
756,1,3,16,15,1,1,Batch Pass 1,2022-08-08 15:29:26.387
756,1,1,6,6,0,3,Variance 1,2022-08-08 16:20:16.857
756,1,2,16,16,0,1,Batch Pass 1,2022-08-08 15:29:26.387
756,1,13,37,0,37,3,Variance 1,2022-08-08 16:20:16.857
756,1,114,125,114,11,1,Batch Pass 1,2022-08-08 15:29:26.387
756,1,1,4,3,1,3,Variance 1,2022-08-08 16:20:16.857
756,1,12,50,48,2,1,Batch Pass 1,2022-08-08 15:29:26.387
756,1,1,7,7,0,1,Batch Pass 1,2022-08-08 15:29:26.387
756,1,23,23,0,23,1,Batch Pass 1,2022-08-08 15:29:26.387
756,1,1,3,1,2,3,Variance 1,2022-08-08 16:20:16.857
756,1,21,63,63,0,1,Batch Pass 1,2022-08-08 15:29:26.387
756,1,4,17,16,1,3,Variance 1,2022-08-08 16:20:16.857
756,1,4,24,24,0,1,Batch Pass 1,2022-08-08 15:29:26.387
756,1,21,45,42,3,1,Batch Pass 1,2022-08-08 15:29:26.387
756,1,4,8,8,0,3,Variance 1,2022-08-08 16:20:16.857
756,1,1,3,5,-2,3,Variance 1,2022-08-08 16:20:16.857
756,1,1,13,12,1,1,Batch Pass 1,2022-08-08 15:29:26.387
756,1,1,15,15,0,1,Batch Pass 1,2022-08-08 15:29:26.387
777,5,13,52,52,0,1,Batch Pass 1,2022-08-12 11:46:30.437
777,5,4,29,28,1,1,Batch Pass 1,2022-08-12 11:46:30.437
777,5,1,11,10,1,1,Batch Pass 1,2022-08-12 11:46:30.437
777,5,4,4,4,0,1,Batch Pass 1,2022-08-12 11:46:30.437
777,5,14,72,70,2,1,Batch Pass 1,2022-08-12 11:46:30.437
777,5,6,49,48,1,1,Batch Pass 1,2022-08-12 11:46:30.437
777,5,36,74,72,2,1,Batch Pass 1,2022-08-12 11:46:30.437
777,5,31,96,93,3,1,Batch Pass 1,2022-08-12 11:46:30.437
777,5,8,48,48,0,1,Batch Pass 1,2022-08-12 11:46:30.437
777,4,18,18,0,18,1,Batch Pass 1,2022-08-11 15:23:22.513
777,4,20,62,60,2,1,Batch Pass 1,2022-08-11 15:23:22.513
777,4,22,66,0,66,6,Variance 4,2022-08-11 15:52:14.603
777,4,16,55,0,55,8,Variance 4 Supplement,2022-08-12 10:47:43.227
777,4,1,3,3,0,6,Variance 4,2022-08-11 15:52:14.603
777,4,1,7,6,1,1,Batch Pass 1,2022-08-11 15:23:22.513
777,4,3,16,3,13,6,Variance 4,2022-08-11 15:52:14.603
777,4,36,71,72,-1,1,Batch Pass 1,2022-08-11 15:23:22.513
777,4,1,4,4,0,6,Variance 4,2022-08-11 15:52:14.603
777,4,6,30,30,0,1,Batch Pass 1,2022-08-11 15:23:22.513
777,4,1,8,8,0,1,Batch Pass 1,2022-08-11 15:23:22.513
777,4,2,20,22,-2,1,Batch Pass 1,2022-08-11 15:23:22.513
777,4,16,55,0,55,8,Variance 4 Supplement,2022-08-12 11:46:30.437
777,4,100,104,100,4,1,Batch Pass 1,2022-08-11 15:23:22.513
777,4,7,28,28,0,1,Batch Pass 1,2022-08-11 15:23:22.513
777,4,2,14,14,0,1,Batch Pass 1,2022-08-11 15:23:22.513
777,4,1,18,17,1,1,Batch Pass 1,2022-08-11 15:23:22.513
777,3,19,60,57,3,1,Batch Pass 1,2022-08-10 13:45:33.977
777,3,2,6,6,0,5,Varaince 3,2022-08-10 14:47:22.483
777,3,5,30,30,0,1,Batch Pass 1,2022-08-10 13:45:33.977
777,3,1,13,13,0,1,Batch Pass 1,2022-08-10 13:45:33.977
777,3,1,19,19,0,1,Batch Pass 1,2022-08-10 13:45:33.977
777,3,104,112,104,8,1,Batch Pass 1,2022-08-10 13:45:33.977
777,3,1,4,2,2,5,Varaince 3,2022-08-10 14:47:22.483
777,3,15,61,60,1,1,Batch Pass 1,2022-08-10 13:45:33.977
777,3,2,9,10,-1,5,Varaince 3,2022-08-10 14:47:22.483
777,3,1,7,7,0,1,Batch Pass 1,2022-08-10 13:45:33.977
777,3,5,14,5,9,5,Varaince 3,2022-08-10 14:47:22.483
777,3,3,13,12,1,5,Varaince 3,2022-08-10 14:47:22.483
777,3,4,19,20,-1,1,Batch Pass 1,2022-08-10 13:45:33.977
777,3,33,64,66,-2,1,Batch Pass 1,2022-08-10 13:45:33.977
777,3,1,9,9,0,1,Batch Pass 1,2022-08-10 13:45:33.977
777,2,12,36,0,36,4,Variance 2,2022-08-09 17:06:48.900
777,2,32,67,64,3,1,Batch Pass 1,2022-08-09 16:00:33.837
777,2,3,12,9,3,4,Variance 2,2022-08-09 17:06:48.900
777,2,6,31,30,1,1,Batch Pass 1,2022-08-09 16:00:33.837
777,2,1,7,6,1,4,Variance 2,2022-08-09 17:06:48.900
777,2,2,16,16,0,1,Batch Pass 1,2022-08-09 16:00:33.837
777,2,24,75,72,3,1,Batch Pass 1,2022-08-09 16:00:33.837
777,2,1,6,5,1,4,Variance 2,2022-08-09 17:06:48.900
777,2,8,8,0,8,1,Batch Pass 1,2022-08-09 16:00:33.837
777,2,3,7,3,4,4,Variance 2,2022-08-09 17:06:48.900
777,2,1,7,7,0,1,Batch Pass 1,2022-08-09 16:00:33.837
777,2,1,10,10,0,1,Batch Pass 1,2022-08-09 16:00:33.837
777,2,123,135,123,12,1,Batch Pass 1,2022-08-09 16:00:33.837
777,2,7,28,28,0,1,Batch Pass 1,2022-08-09 16:00:33.837
777,2,1,4,4,0,4,Variance 2,2022-08-09 17:06:48.900
777,2,1,7,7,0,4,Variance 2,2022-08-09 17:06:48.900
777,1,1,2,1,1,3,Variance 1,2022-08-08 18:44:19.977
777,1,43,80,86,-6,1,Batch Pass 1,2022-08-08 17:26:11.143
777,1,5,27,25,2,1,Batch Pass 1,2022-08-08 17:26:11.143
777,1,1,8,11,-3,3,Variance 1,2022-08-08 18:44:19.977
777,1,1,2,2,0,3,Variance 1,2022-08-08 18:44:19.977
777,1,2,12,10,2,3,Variance 1,2022-08-08 18:44:19.977
777,1,2,13,12,1,1,Batch Pass 1,2022-08-08 17:26:11.143
777,1,15,15,0,15,1,Batch Pass 1,2022-08-08 17:26:11.143
777,1,20,60,60,0,1,Batch Pass 1,2022-08-08 17:26:11.143
777,1,1,7,3,4,3,Variance 1,2022-08-08 18:44:19.977
777,1,1,12,12,0,3,Variance 1,2022-08-08 18:44:19.977
777,1,1,13,13,0,1,Batch Pass 1,2022-08-08 17:26:11.143
777,1,10,34,0,34,3,Variance 1,2022-08-08 18:44:19.977
777,1,112,122,112,10,1,Batch Pass 1,2022-08-08 17:26:11.143
777,1,9,35,36,-1,1,Batch Pass 1,2022-08-08 17:26:11.143
777,1,1,8,7,1,1,Batch Pass 1,2022-08-08 17:26:11.143
777,1,1,10,10,0,3,Variance 1,2022-08-08 18:44:19.977
922,4,48,101,96,5,1,Batch Pass 1,2022-08-11 15:51:03.607
922,4,1,3,6,-3,6,Variance 4,2022-08-11 16:24:43.780
922,4,3,3,0,3,1,Batch Pass 1,2022-08-11 15:51:03.607
922,4,2,5,0,5,6,Variance 4,2022-08-11 16:24:43.780
922,4,24,71,72,-1,1,Batch Pass 1,2022-08-11 15:51:03.607
922,4,1,3,3,0,6,Variance 4,2022-08-11 16:24:43.780
922,4,3,18,18,0,1,Batch Pass 1,2022-08-11 15:51:03.607
922,4,108,110,108,2,1,Batch Pass 1,2022-08-11 15:51:03.607
922,4,1,4,1,3,6,Variance 4,2022-08-11 16:24:43.780
922,4,6,24,24,0,1,Batch Pass 1,2022-08-11 15:51:03.607
922,4,3,22,21,1,1,Batch Pass 1,2022-08-11 15:51:03.607
922,4,2,28,34,-6,6,Variance 4,2022-08-11 16:24:43.780
922,4,1,6,2,4,6,Variance 4,2022-08-11 16:24:43.780
922,4,7,34,35,-1,1,Batch Pass 1,2022-08-11 15:51:03.607
922,4,2,13,10,3,6,Variance 4,2022-08-11 16:24:43.780
922,4,2,16,16,0,1,Batch Pass 1,2022-08-11 15:51:03.607
922,4,1,11,11,0,1,Batch Pass 1,2022-08-11 15:51:03.607
922,3,1,3,1,2,5,Varaince 3,2022-08-10 18:18:28.413
922,3,26,78,78,0,1,Batch Pass 1,2022-08-10 17:31:24.437
922,3,2,13,12,1,1,Batch Pass 1,2022-08-10 17:31:24.437
922,3,1,8,14,-6,5,Varaince 3,2022-08-10 18:18:28.413
922,3,54,106,108,-2,1,Batch Pass 1,2022-08-10 17:31:24.437
922,3,2,4,4,0,5,Varaince 3,2022-08-10 18:18:28.413
922,3,2,10,10,0,1,Batch Pass 1,2022-08-10 17:31:24.437
922,3,1,8,8,0,1,Batch Pass 1,2022-08-10 17:31:24.437
922,3,7,19,0,19,5,Varaince 3,2022-08-10 18:18:28.413
922,3,125,130,125,5,1,Batch Pass 1,2022-08-10 17:31:24.437
922,3,12,47,48,-1,1,Batch Pass 1,2022-08-10 17:31:24.437
922,3,1,14,14,0,1,Batch Pass 1,2022-08-10 17:31:24.437
922,3,2,2,0,2,1,Batch Pass 1,2022-08-10 17:31:24.437
922,3,1,4,4,0,5,Varaince 3,2022-08-10 18:18:28.413
922,3,4,26,28,-2,1,Batch Pass 1,2022-08-10 17:31:24.437
922,2,46,89,92,-3,1,Batch Pass 1,2022-08-09 16:42:32.350
922,2,1,6,3,3,4,Variance 2,2022-08-09 17:11:53.813
922,2,5,25,25,0,1,Batch Pass 1,2022-08-09 16:42:32.350
922,2,1,2,9,-7,4,Variance 2,2022-08-09 17:11:53.813
922,2,10,10,0,10,1,Batch Pass 1,2022-08-09 16:42:32.350
922,2,3,10,0,10,4,Variance 2,2022-08-09 17:11:53.813
922,2,20,62,60,2,1,Batch Pass 1,2022-08-09 16:42:32.350
922,2,1,6,6,0,1,Batch Pass 1,2022-08-09 16:42:32.350
922,2,1,13,10,3,4,Variance 2,2022-08-09 17:11:53.813
922,2,1,1,1,0,4,Variance 2,2022-08-09 17:11:53.813
922,2,12,50,48,2,1,Batch Pass 1,2022-08-09 16:42:32.350
922,2,2,8,8,0,4,Variance 2,2022-08-09 17:11:53.813
922,2,1,10,10,0,1,Batch Pass 1,2022-08-09 16:42:32.350
922,2,127,134,127,7,1,Batch Pass 1,2022-08-09 16:42:32.350
922,2,4,10,8,2,4,Variance 2,2022-08-09 17:11:53.813
922,2,1,4,5,-1,4,Variance 2,2022-08-09 17:11:53.813
922,2,3,23,24,-1,1,Batch Pass 1,2022-08-09 16:42:32.350
922,2,1,8,8,0,4,Variance 2,2022-08-09 17:11:53.813
922,1,11,11,0,11,1,Batch Pass 1,2022-08-08 17:02:05.117
922,1,21,63,63,0,1,Batch Pass 1,2022-08-08 17:02:05.117
922,1,2,12,12,0,3,Variance 1,2022-08-08 17:36:40.877
922,1,1,9,9,0,3,Variance 1,2022-08-08 17:36:40.877
922,1,1,10,10,0,1,Batch Pass 1,2022-08-08 17:02:05.117
922,1,1,16,16,0,1,Batch Pass 1,2022-08-08 17:02:05.117
922,1,4,6,0,6,3,Variance 1,2022-08-08 17:36:40.877
922,1,103,110,103,7,1,Batch Pass 1,2022-08-08 17:02:05.117
922,1,3,10,9,1,3,Variance 1,2022-08-08 17:36:40.877
922,1,9,37,36,1,1,Batch Pass 1,2022-08-08 17:02:05.117
922,1,2,14,14,0,1,Batch Pass 1,2022-08-08 17:02:05.117
922,1,1,30,30,0,1,Batch Pass 1,2022-08-08 17:02:05.117
922,1,1,4,4,0,3,Variance 1,2022-08-08 17:36:40.877
922,1,1,5,5,0,1,Batch Pass 1,2022-08-08 17:02:05.117
922,1,1,9,8,1,1,Batch Pass 1,2022-08-08 17:02:05.117
922,1,1,11,11,0,1,Batch Pass 1,2022-08-08 17:02:05.117
922,1,29,58,58,0,1,Batch Pass 1,2022-08-08 17:02:05.117
922,1,2,4,4,0,3,Variance 1,2022-08-08 17:36:40.877
922,1,1,6,6,0,1,Batch Pass 1,2022-08-08 17:02:05.117
922,1,1,9,9,0,1,Batch Pass 1,2022-08-08 17:02:05.117
941,5,24,49,48,1,1,Batch Pass 1,2022-08-12 10:22:26.523
941,5,3,9,9,0,7,Variance 5,2022-08-12 10:59:27.100
941,5,1,6,6,0,7,Variance 5,2022-08-12 10:59:27.100
941,5,4,11,4,7,7,Variance 5,2022-08-12 10:59:27.100
941,5,4,16,16,0,7,Variance 5,2022-08-12 10:59:27.100
941,5,4,20,20,0,1,Batch Pass 1,2022-08-12 10:22:26.523
941,5,2,16,14,2,7,Variance 5,2022-08-12 10:59:27.100
941,5,1,8,8,0,1,Batch Pass 1,2022-08-12 10:22:26.523
941,5,1,36,39,-3,7,Variance 5,2022-08-12 10:59:27.100
941,5,165,172,165,7,1,Batch Pass 1,2022-08-12 10:22:26.523
941,5,10,40,40,0,1,Batch Pass 1,2022-08-12 10:22:26.523
941,5,1,5,5,0,7,Variance 5,2022-08-12 10:59:27.100
941,5,1,7,7,0,1,Batch Pass 1,2022-08-12 10:22:26.523
941,5,3,25,24,1,7,Variance 5,2022-08-12 10:59:27.100
941,5,1,17,17,0,1,Batch Pass 1,2022-08-12 10:22:26.523
941,5,4,11,8,3,7,Variance 5,2022-08-12 10:59:27.100
941,5,15,46,45,1,1,Batch Pass 1,2022-08-12 10:22:26.523
941,5,6,36,36,0,1,Batch Pass 1,2022-08-12 10:22:26.523
941,4,3,23,9,14,6,Variance 4,2022-08-11 17:29:47.660
941,4,2,7,12,-5,8,Variance 4 Supplement,2022-08-12 09:45:38.350
941,4,1,24,23,1,1,Batch Pass 1,2022-08-11 12:26:01.220
941,4,1,7,6,1,1,Batch Pass 1,2022-08-11 12:26:01.220
941,4,1,3,6,-3,6,Variance 4,2022-08-11 17:29:47.660
941,4,1,8,8,0,8,Variance 4 Supplement,2022-08-12 09:45:38.350
941,4,2,4,2,2,8,Variance 4 Supplement,2022-08-12 09:45:38.350
941,4,2,6,4,2,1,Batch Pass 1,2022-08-11 12:26:01.220
941,4,1,13,4,9,8,Variance 4 Supplement,2022-08-12 09:45:38.350
941,4,1,8,7,1,8,Variance 4 Supplement,2022-08-12 09:45:38.350
941,4,1,35,15,20,6,Variance 4,2022-08-11 17:29:47.660
941,4,1,35,17,18,8,Variance 4 Supplement,2022-08-12 09:45:38.350
941,4,2,9,0,9,8,Variance 4 Supplement,2022-08-12 09:45:38.350
941,4,5,9,5,4,1,Batch Pass 1,2022-08-11 12:26:01.220
941,4,2,4,2,2,6,Variance 4,2022-08-11 17:29:47.660
941,4,2,10,6,4,8,Variance 4 Supplement,2022-08-12 09:45:38.350
941,4,1,5,4,1,6,Variance 4,2022-08-11 17:29:47.660
941,4,2,16,14,2,6,Variance 4,2022-08-11 17:29:47.660
941,3,113,115,113,2,1,Batch Pass 1,2022-08-10 10:39:49.640
941,3,2,7,4,3,5,Varaince 3,2022-08-10 11:17:56.413
941,3,1,3,1,2,5,Varaince 3,2022-08-10 11:17:56.413
941,3,6,24,24,0,1,Batch Pass 1,2022-08-10 10:39:49.640
941,3,3,11,12,-1,5,Varaince 3,2022-08-10 11:17:56.413
941,3,21,64,63,1,1,Batch Pass 1,2022-08-10 10:39:49.640
941,3,2,6,6,0,5,Varaince 3,2022-08-10 11:17:56.413
941,3,1,6,6,0,1,Batch Pass 1,2022-08-10 10:39:49.640
941,3,35,68,70,-2,1,Batch Pass 1,2022-08-10 10:39:49.640
941,3,6,30,30,0,1,Batch Pass 1,2022-08-10 10:39:49.640
941,3,1,9,9,0,1,Batch Pass 1,2022-08-10 10:39:49.640
941,3,1,15,12,3,5,Varaince 3,2022-08-10 11:17:56.413
941,3,1,17,15,2,5,Varaince 3,2022-08-10 11:17:56.413
941,2,5,17,10,7,4,Variance 2,2022-08-09 10:10:40.123
941,2,10,31,30,1,1,Batch Pass 1,2022-08-09 09:43:20.867
941,2,1,6,6,0,1,Batch Pass 1,2022-08-09 09:43:20.867
941,2,1,9,9,0,1,Batch Pass 1,2022-08-09 09:43:20.867
941,2,23,49,46,3,1,Batch Pass 1,2022-08-09 09:43:20.867
941,2,1,3,3,0,4,Variance 2,2022-08-09 10:10:40.123
941,2,5,25,25,0,1,Batch Pass 1,2022-08-09 09:43:20.867
941,2,1,6,6,0,4,Variance 2,2022-08-09 10:10:40.123
941,2,124,129,124,5,1,Batch Pass 1,2022-08-09 09:43:20.867
941,2,1,4,1,3,4,Variance 2,2022-08-09 10:10:40.123
941,2,3,12,12,0,4,Variance 2,2022-08-09 10:10:40.123
941,2,12,49,48,1,1,Batch Pass 1,2022-08-09 09:43:20.867
941,2,1,3,5,-2,4,Variance 2,2022-08-09 10:10:40.123
941,2,1,7,7,0,1,Batch Pass 1,2022-08-09 09:43:20.867
941,2,1,8,8,0,4,Variance 2,2022-08-09 10:10:40.123
941,2,1,14,11,3,4,Variance 2,2022-08-09 10:10:40.123
941,1,10,40,40,0,1,Batch Pass 1,2022-08-08 14:02:20.580
941,1,1,4,4,0,3,Variance 1,2022-08-08 14:54:09.537
941,1,1,23,23,0,1,Batch Pass 1,2022-08-08 14:02:20.580
941,1,130,134,130,4,1,Batch Pass 1,2022-08-08 14:02:20.580
941,1,3,9,9,0,3,Variance 1,2022-08-08 14:54:09.537
941,1,1,10,6,4,3,Variance 1,2022-08-08 14:54:09.537
941,1,22,42,44,-2,1,Batch Pass 1,2022-08-08 14:02:20.580
941,1,2,6,4,2,3,Variance 1,2022-08-08 14:54:09.537
941,1,5,25,25,0,1,Batch Pass 1,2022-08-08 14:02:20.580
941,1,1,6,5,1,3,Variance 1,2022-08-08 14:54:09.537
941,1,11,36,33,3,1,Batch Pass 1,2022-08-08 14:02:20.580
941,1,1,6,6,0,1,Batch Pass 1,2022-08-08 14:02:20.580
949,4,80,95,80,15,1,Batch Pass 1,2022-08-11 17:38:46.907
949,4,3,13,12,1,1,Batch Pass 1,2022-08-11 17:38:46.907
949,4,5,20,20,0,6,Variance 4,2022-08-11 18:35:38.210
949,4,1,7,7,0,6,Variance 4,2022-08-11 18:35:38.210
949,4,21,61,0,61,6,Variance 4,2022-08-11 18:35:38.210
949,4,5,15,15,0,6,Variance 4,2022-08-11 18:35:38.210
949,4,1,6,5,1,1,Batch Pass 1,2022-08-11 17:38:46.907
949,4,3,18,18,0,6,Variance 4,2022-08-11 18:35:38.210
949,4,17,34,34,0,1,Batch Pass 1,2022-08-11 17:38:46.907
949,4,10,23,20,3,6,Variance 4,2022-08-11 18:35:38.210
949,4,1,12,12,0,6,Variance 4,2022-08-11 18:35:38.210
949,4,28,28,0,28,1,Batch Pass 1,2022-08-11 17:38:46.907
949,4,3,9,3,6,6,Variance 4,2022-08-11 18:35:38.210
949,4,2,7,6,1,1,Batch Pass 1,2022-08-11 17:38:46.907
949,4,1,8,8,0,6,Variance 4,2022-08-11 18:35:38.210
949,3,18,18,0,18,1,Batch Pass 1,2022-08-10 15:04:26.417
949,3,8,17,8,9,5,Varaince 3,2022-08-10 16:51:43.747
949,3,1,4,4,0,5,Varaince 3,2022-08-10 16:51:43.747
949,3,4,6,0,6,5,Varaince 3,2022-08-10 16:51:43.747
949,3,88,97,88,9,1,Batch Pass 1,2022-08-10 15:04:26.417
949,3,5,20,20,0,1,Batch Pass 1,2022-08-10 15:04:26.417
949,3,9,19,18,1,1,Batch Pass 1,2022-08-10 15:04:26.417
949,3,5,17,15,2,5,Varaince 3,2022-08-10 16:51:43.747
949,3,1,7,6,1,5,Varaince 3,2022-08-10 16:51:43.747
949,3,8,19,16,3,5,Varaince 3,2022-08-10 16:51:43.747
949,3,5,15,15,0,1,Batch Pass 1,2022-08-10 15:04:26.417
949,3,2,9,10,-1,5,Varaince 3,2022-08-10 16:51:43.747
949,3,1,6,6,0,1,Batch Pass 1,2022-08-10 15:04:26.417
949,2,25,25,0,25,1,Batch Pass 1,2022-08-09 13:44:18.890
949,2,4,8,4,4,4,Variance 2,2022-08-09 16:45:43.120
949,2,21,62,63,-1,1,Batch Pass 1,2022-08-09 13:44:18.890
949,2,1,4,4,0,4,Variance 2,2022-08-09 16:45:43.120
949,2,2,14,12,2,1,Batch Pass 1,2022-08-09 13:44:18.890
949,2,26,52,52,0,1,Batch Pass 1,2022-08-09 13:44:18.890
949,2,4,12,8,4,4,Variance 2,2022-08-09 16:45:43.120
949,2,2,10,10,0,1,Batch Pass 1,2022-08-09 13:44:18.890
949,2,28,77,0,77,4,Variance 2,2022-08-09 16:45:43.120
949,2,99,106,99,7,1,Batch Pass 1,2022-08-09 13:44:18.890
949,2,4,17,12,5,4,Variance 2,2022-08-09 16:45:43.120
949,2,7,29,28,1,1,Batch Pass 1,2022-08-09 13:44:18.890
949,1,7,13,0,13,3,Variance 1,2022-08-08 15:21:26.620
949,1,105,113,105,8,1,Batch Pass 1,2022-08-08 14:45:47.450
949,1,1,2,3,-1,3,Variance 1,2022-08-08 15:21:26.620
949,1,4,10,4,6,3,Variance 1,2022-08-08 15:21:26.620
949,1,25,47,50,-3,1,Batch Pass 1,2022-08-08 14:45:47.450
949,1,4,30,16,14,3,Variance 1,2022-08-08 15:21:26.620
949,1,2,9,10,-1,1,Batch Pass 1,2022-08-08 14:45:47.450
949,1,22,22,0,22,1,Batch Pass 1,2022-08-08 14:45:47.450
949,1,6,19,12,7,3,Variance 1,2022-08-08 15:21:26.620
949,1,15,47,45,2,1,Batch Pass 1,2022-08-08 14:45:47.450
949,1,1,6,6,0,1,Batch Pass 1,2022-08-08 14:45:47.450
949,1,5,19,20,-1,1,Batch Pass 1,2022-08-08 14:45:47.450
